Lex	Type	Regex	Direction	Codes
аневризма	аневризма	\b(аневризм|аневризматическ)[а-я]* расширени[а-я]*		
аппендицит	аппендицит	\bаппендицит[а-я]*		ABD/Pel
вдавленный перелом черепа	вдавленный перелом черепа	\b(вдавлен[а-я]+ перелом[а-я]* череп[а-я]*)		Neuro
венозный воздух	венозный воздух	\b(венозн[а-я]* (воздух|газ)[а-я]*|(воздух|газ)[а-я]* в( (портальн|воротн)[а-я]+)? вен[а-я]+)		ABD/Pel
внематочная беременность	внематочная беременность	\bвнематочн[а-я]+ беременност[а-я]+		ABD/Pel
внутричерепное кровоизлияние	внутричерепное кровоизлияние	\b((внутримозгов|внутричерепн|паренхиматозн)[а-я]* кровоизлияни[а-я]+|геморрагическ[а-я]+ инсульт[а-я]*)		Neuro
воспаление	воспаление	\b(воспалени|воспалительн|инфекци)[а-я]*		Spine, Neuro, ABD/Pel, Extremity
гибель плода	гибель плода	\b((гибел|смерт)[а-я]+ плода|внутриутробн[а-я]+ (гибел|смерт)[а-я]+)		ABD/Pel
дивертикулит	дивертикулит	\b(дивертикулит[а-я]*)		ABD/Pel
забрюшинное кровоизлияние	забрюшинное кровоизлияние	\b((забрюшинн|ретроперитонеальн)[а-я]+ (кровоизлиян|кровотечен|гематом)[а-я]+)		ABD/Pel
заворот кишок	заворот кишок	\b(заворот[а-я]* кишок|кишечн[а-я]+ непроходимост[а-я]+)		ABD/Pel
инфаркт	инфаркт	\b((инсульт|инфаркт)[а-я]*)		Neuro, ABD/Pel
инфаркт кости	инфаркт кости	\b(инфаркт[а-я]* (кости|костного мозга)|(ишемическ[а-я]+ )?некроз[а-я]* кости|остеонекроз[а-я]*)		Extremity
инфаркт почки	инфаркт почки	\b(инфаркт[а-я]* почки|почечн[а-я]+ инфаркт[а-я]*)		ABD/Pel
инфаркт сальника	инфаркт сальника	\b(инфаркт[а-я]* сальника)		ABD/Pel
инфаркт селезенки	инфаркт селезенки	\b(селезеночн[а-я]+ инфаркт[а-я]*|инфаркт[а-я]* селезенки)		Chest, ABD/Pel
ишемия кишечника	ишемия кишечника	\b(ишеми[а-я]+( болезнь)? кишечника)		ABD/Pel
каротидная диссекция	каротидная диссекция	\b(каротидн[а-я]+ диссекци[а-я]+)		Neuro
кишечная непроходимость	кишечная непроходимость	\bкишечн[а-я]+ непроходимост[а-я]+		ABD/Pel
лакунарный инфаркт	лакунарный инфаркт	\b(лакунарн[а-я]+ (инфаркт|инсульт)[а-я]*)		Neuro
легочная эмболия	легочная эмболия	\b((л(е|ё)гочн[а-я]* эмболи[а-я]*|эмболи[а-я]* (л(е|ё)гких|сосудов)|тромбоэмболи[а-я]* л(е|ё)гочной артерии))		Chest
перелом	перелом	\b(перелом|трещин|разрыв)[а-я]*		Spine, Neuro, ABD/Pel, Chest, Extremity
пневмония	пневмония	\b(пневмони[а-я]+|воспален[а-я]+ л(е|ё)гких)		Chest
пневмоторакс	пневмоторакс	\b((гидро )?пневмоторакс[а-я]*)		Chest
разрыв аневризмы	разрыв аневризмы	\b((разрыв[а-я]*|разорванн[а-я]+)( )?(аорт|аневризм)[а-я]*)		Chest, Neuro, ABD/Pel
рак	рак	\b((рак|метаста(т|з)|карцином|сарком)[а-я]*|злокачествен[а-я]+)		Spine, Neuro, ABD/Pel, Chest, Extremity
расслоение аорты	расслоение аорты	\b(расслоени[а-я]* аорты|расслаивающ[а-я]* аневризм[а-я]* аорты)		Chest, ABD/Pel
ретрофарингеальный абсцесс	ретрофарингеальный абсцесс	\b((ретрофарингеальн|заглоточн)[а-я]+ абсцесс[а-я]*)		Chest
свободный воздух	свободный воздух	\b(пневмоперитонеум[а-я]*|свободн[а-я]+ (газ|воздух)[а-я]*)		Chest, ABD/Pel
скручивание	скручивание	\b(скручиван[а-я]+|перекрут[а-я]*)		ABD/Pel
смещение срединных структур	смещение срединных структур	\b(дислокаци[а-я]+( головного)? мозга|смещени[а-я]+ срединных структур(( головного)? мозга)?|дислокационн[а-я]+ синдром[а-я]*)		Neuro
спинальная компрессия	спинальная компрессия	\b(спинальн[а-я]+ компресси[а-я]+|(сдавлени|компресси)[а-я]+ спинного мозга)		Extremity, Spine, Neuro
средостенная эмфизема	средостенная эмфизема	\b(средостенн[а-я]+ эмфизем[а-я]*|эмфизем[а-я]* средостени[а-я]*|пневмомедиастинум[а-я]*)		Chest
тромбоз	тромбоз	\b(тромбоз[а-я]*|тромбированн[а-я]+)		Spine, Neuro, ABD/Pel, Extremity
тромбоз глубоких вен	тромбоз глубоких вен	\b((тромбоз|тромбофлебит)[а-я]* глубоких вен|ТГВ)		ABD/Pel
холецистит	холецистит	\bхолецистит[а-я]*		ABD/Pel
эктазия	эктазия	\bэктази[а-я]+		ABD/Pel
эпиглоттит	эпиглоттит	\bэпиглоттит[а-я]*		Chest
Аббревиатоз	Аббревиатоз	\bаббревиатоз[а-я]*		
Абсанс	Абсанс	\bабсанс[а-я]*		
Абсцесс	Абсцесс	\bабсцесс[а-я]* (головного мозга|зуб|л(ё|е)гк)[а-я]+		
Авитаминоз	Авитаминоз	\bавитаминоз[а-я]*		
Агалактия	Агалактия	\bагалакти[а-я]+		
Агорафобия	Агорафобия	\bагорафоби[а-я]+		
Агранулоцитоз	Агранулоцитоз	\bагранулоцитоз[а-я]*		
Аддисонический криз	Аддисонический криз	\bаддисоническ[а-я]+ криз[а-я]*		
Аденовирусная инфекция	Аденовирусная инфекция	\bаденовирусн[а-я]+ инфекц[а-я]+		
Аденоиды	Аденоиды	\bаденоид[а-я]*		
Аденокарцинома	Аденокарцинома	\bаденокарцином[а-я]*		
Аденома	Аденома	\bаденом[а-я]* (гипофиз|надпочечник|((пара)?щитовидн|сальн)[а-я]*) жел(е|ё)з[а-я]*		
Аденоматозный полип	Аденоматозный полип	\bаденоматозн[а-я]+ полип[а-я]*		
Адреналэктомия	Адреналэктомия	\bадреналэктом[а-я]+		
Ажитация	Ажитация	\bажитац[а-я]+		
Азооспермия	Азооспермия	\bазоосперм[а-я]+		
Азотное отравление	Азотное отравление	\bазотн[а-я]* отравлен[а-я]+		
Акантамёбный кератит	Акантамёбный кератит	\bакантам(ё|е)бн[а-я]* кератит[а-я]*		
Акантохейлонематоз	Акантохейлонематоз	\bакантохейлонематоз[а-я]*		
Акантоцефалёзы	Акантоцефалёзы	\bакантоцефал(ё|е)з[а-я]*		
Акариазы	Акариазы	\bакариаз[а-я]*		
Акародерматит	Акародерматит	\bакародерматит[а-я]*		
Акне	Акне	\b(акне|угр)[а-я]*		
Акрания	Акрания	\bакрания[а-я]+		
Акрокефалия	Акрокефалия	\bакрокефал[а-я]+		
Акромегалия	Акромегалия	\bакромегал[а-я]+		
Актиномикоз	Актиномикоз	\bактиномикоз[а-я]*		
Актиномикома	Актиномикома	\bактиномиком[а-я]+		
Акустикофобия	Акустикофобия	\bакустикофоб[а-я]*		
Акушерские кровотечения	Акушерские кровотечения	\bакушерск[а-я]* (кровотечен|паралич)[а-я]*		
Алиментарная дистрофия	Алиментарная дистрофия	\bалиментарн[а-я]* дистрофи[а-я]*		
Алкаптонурия	Алкаптонурия	\bалкаптонури[а-я]*		
Алкоголизм	Алкоголизм	\bалкоголизм[а-я]*		
Алкогольная кардиомиопатия	Алкогольная кардиомиопатия	\bалкогольн[а-я]+ ((кардиомиопат|полинейропат|опьянен|делири)[а-я]*)		
Аллергические реакции на введение инсулина	Аллергические реакции на введение инсулина	\bаллерги[а-я]+( реакции)? на( введение)? инсулин[а-я]*		
Аллергия	Аллергия	\bаллерги[а-я]*		
Алопеция	Алопеция	\bалопеци[а-я]*		
Альбинизм	Альбинизм	\bальбинизм[а-я]*		
Альвеококкоз	Альвеококкоз	\bальвеококкоз[а-я]*		
Альвеолярная мягкотканная саркома	Альвеолярная мягкотканная саркома	\bальвеолярн[а-я]+ мягкотканн[а-я]+ сарком[а-я]*		
Альфа-маннозидоз	Альфа-маннозидоз	\bальфа-маннозидоз[а-я]*		
Амавроз Лебера	Амавроз Лебера	\bамавроз[а-я]* лебера		
Амастия	Амастия	\bамасти[а-я]*		
Амблиопия	Амблиопия	\bамблиопи[а-я]+		
Амёбиаз	Амёбиаз	\bам(ё|е)биаз[а-я]*		
Амелобластома	Амелобластома	\bамелобластом[а-я]*		
Аменорея	Аменорея	\bаменор[а-я]+		
Аметропия	Аметропия	\bаметропи[а-я]+		
Амилоидоз	Амилоидоз	\bамилоидоз[а-я]*( финского типа)?		
Амнезия	Амнезия	\bамнези[а-я]+		
Амок	Амок	\bамок[а-я]*		
Анальный миаз	Анальный миаз	\bанальн[а-я]+ миаз[а-я]*		
Ананкастное расстройство личности	Ананкастное расстройство личности	\bананкастн[а-я]+ расстройств[а-я]* личности		
Анаплазмоз	Анаплазмоз	\bанаплазмоз[а-я]*		
Анафилактический шок	Анафилактический шок	\bанафилактическ[а-я]+ шок[а-я]*		
Анаэробная инфекционная энтеротоксемия	Анаэробная инфекционная энтеротоксемия	\bанаэробн[а-я]+ инфекционн[а-я]+ энтеротоксеми[а-я]+		
Ангидроз	Ангидроз	\bангидроз[а-я]*		
Ангидротическая эктодермальная дисплазия	Ангидротическая эктодермальная дисплазия	\bангидротическ[а-я]+ эктодермальн[а-я]+ дисплази[а-я]+		
Ангина герпетическая	Ангина герпетическая	\bангин[а-я]* герпетическ[а-я]+		
Ангина Людвига	Ангина Людвига	\bангин[а-я]* людвига		
Ангина язвенно-плёнчатая	Ангина язвенно-плёнчатая	\bангин[а-я]* язвенно-пл(ё|е)нчат[а-я]+		
Ангиокератома	Ангиокератома	\bангиокератом[а-я]*		
Ангионевротический отёк	Ангионевротический отёк	\bангионевротическ[а-я]+ от(ё|е)к[а-я]*		
Ангиосаркома	Ангиосаркома	\bангиосарком[а-я]*		
Ангиостронгилёз	Ангиостронгилёз	\bангиостронгил(ё|е)з[а-я]*		
Английский пот	Английский пот	\bанглийск[а-я]+ пот[а-я]*		
Андрофобия	Андрофобия	\bандрофоби[а-я]*		
Аневризма	Аневризма	\bаневризм[а-я]*( аорты| сосудов головного мозга)?		
Анемия Фанкони	Анемия Фанкони	\bанем[а-я]+ фанкони		
Анеуплоидия	Анеуплоидия	\bанеуплоиди[а-я]*		
Анизакидоз	Анизакидоз	\bанизакидоз[а-я]*		
Анизометропия	Анизометропия	\bанизометропи[а-я]+		
Анизоцитоз	Анизоцитоз	\bанизоцитоз[а-я]*		
Аниридия	Аниридия	\bанириди[а-я]*		
Анкилоз	Анкилоз	\bанкилоз[а-я]*		
Анкилостомидозы	Анкилостомидозы	\bанкилостомидоз[а-я]*		
Анкилостомоз	Анкилостомоз	\bанкилостомоз[а-я]*		
Аномалия Эбштейна	Аномалия Эбштейна	\bаномал[а-я]+ эбштейна		
Анопсия	Анопсия	\bанопси[а-я]+		
Анорхизм	Анорхизм	\bанорхизм[а-я]*		
Анофтальм	Анофтальм	\bанофтальм[а-я]*		
Антифосфолипидный синдром	Антифосфолипидный синдром	\bантифосфолипидн[а-я]+ синдром[а-я]*		
Антомиаз	Антомиаз	\bантомиаз[а-я]*		
Антропофобия	Антропофобия	\bантропофоби[а-я]*		
Анэнцефалия	Анэнцефалия	\bанэнцефали[а-я]+		
Аортит	Аортит	\bаортит[а-я]*		
Апикальный периодонтит	Апикальный периодонтит	\bапикальн[а-я]+ периодонтит[а-я]*		
Апифобия	Апифобия	\bапифоби[а-я]+		
Аплазия	Аплазия	\bаплази[а-я]+		
Апластическая анемия	Апластическая анемия	\bапластическ[а-я]+ анеми[а-я]*		
Апноэ во сне	Апноэ во сне	\bапноэ во сне		
Апофаллоз	Апофаллоз	\bапофаллоз[а-я]*		
Аппендицит	Аппендицит	\bаппендицит[а-я]*		
Апраксия	Апраксия	\bапракси[а-я]+		
Апудома	Апудома	\bапудом[а-я]*		
Арахнидизм	Арахнидизм	\bарахнидизм[а-я]*		
Арахнодактилия	Арахнодактилия	\bарахнодактили[а-я]+		
Арахноидальная киста	Арахноидальная киста	\bарахноидальн[а-я]+ кист[а-я]*		
Арахноидит	Арахноидит	\bарахноидит[а-я]*		
Арахноэнтомозы	Арахноэнтомозы	\bарахноэнтомоз[а-я]*		
Арбовирусы	Арбовирусы	\bарбовирус[а-я]*		
Аргазидозы	Аргазидозы	\bаргазидоз[а-я]*		
Аргасоз	Аргасоз	\bаргасоз[а-я]*		
Аргентинская геморрагическая лихорадка	Аргентинская геморрагическая лихорадка	\bаргентинск[а-я]+ геморрагическ[а-я]+ лихорадк[а-я]+		
Аргироз	Аргироз	\bаргироз[а-я]*		
Аритмия сердца	Аритмия сердца	\bаритм[а-я]+ сердца		
Аритмогенная дисплазия правого желудочка	Аритмогенная дисплазия правого желудочка	\bаритмогенн[а-я]+ дисплаз[а-я]+ правого желудочка		
Армиллифериоз	Армиллифериоз	\bармиллифериоз[а-я]*		
Артериальная гипертензия	Артериальная гипертензия	\bартериальн[а-я]+ гипертензи[а-я]+		
Артериальная гипотензия	Артериальная гипотензия	\bартериальн[а-я]+ гипотензи[а-я]+		
Артериовенозная мальформация	Артериовенозная мальформация	\bартериовеноз[а-я]* мальформаци[а-я]+		
Артериовенозная фистула	Артериовенозная фистула	\bартериовеноз[а-я]* фистул[а-я]*		
Артрит	Артрит	\bартрит[а-я]*		
Артрогрипоз	Артрогрипоз	\bартрогрипоз[а-я]*		
Асимптоматический хронический простатит	Асимптоматический хронический простатит	\bасимптоматическ[а-я]+ хроническ[а-я]* простатит[а-я]*		
Аскаридоз	Аскаридоз	\bаскаридоз[а-я]*		
Аспартилглюкозаминурия	Аспартилглюкозаминурия	\bаспартилглюкозаминури[а-я]+		
Аспергиллёз	Аспергиллёз	\bаспергилл(ё|е)з[а-я]*		
Аспергиллома	Аспергиллома	\bаспергиллом[а-я]*		
Аспермия	Аспермия	\bасперми[а-я]+		
Аспирационная пневмония	Аспирационная пневмония	\bаспирационн[а-я]+ пневмони[а-я]+		
Аспириновая бронхиальная астма	Аспириновая бронхиальная астма	\bаспиринов[а-я]+ бронхиальн[а-я]+ астм[а-я]+		
Астигматизм	Астигматизм	\bастигмати[а-я]*( статус)?		
Астроцитома	Астроцитома	\bастроцитом[а-я]*		
Асфиксия	Асфиксия	\bасфикси[а-я]*		
Асцит	Асцит	\bасцит[а-я]*		
Атаксия телеангиэктазия	Атаксия телеангиэктазия	\bатакс[а-я]+ (телеангиэктази[а-я]+|фридрейха)		
Атерогенная дислипидемия	Атерогенная дислипидемия	\bатерогенн[а-я]+ дислипидеми[а-я]+		
Атерома кожи	Атерома кожи	\bатером[а-я]* кожи		
Атеросклероз	Атеросклероз	\bатеросклероз[а-я]*		
Атипичная депрессия	Атипичная депрессия	\bатипичн[а-я]+ депресси[а-я]*		
Атипичная пневмония	Атипичная пневмония	\bатипичн[а-я]+ пневмони[а-я]+		
Атипичный аутизм	Атипичный аутизм	\bатипичн[а-я]+ аутизм[а-я]*		
Атопический дерматит	Атопический дерматит	\bатопическ[а-я]+ дерматит		
Атрезия желчевыводящих путей	Атрезия желчевыводящих путей	\bатрез[а-я]+ (желчевыводящих путей|пищевода)		
Атриовентрикулярная блокада	Атриовентрикулярная блокада	\bатриовентрикулярн[а-я]+ блокад[а-я]*		
Атрофический гастрит	Атрофический гастрит	\bатрофическ[а-я]+ (гастрит|ринит)[а-я]*		
Атрофия	Атрофия	\bатрофи[а-я]+( кожи)?		
Аутизм	Аутизм	\bаутизм[а-я]*		
Аутоиммунные заболевания	Аутоиммунные заболевания	\bаутоиммунн[а-я]* (заболеван|гепатит|полиэндокринный синдром|тиреоидит)[а-я]*		
Афазия	Афазия	\bафази[а-я]* (Брока|Вернике)?		
Афакия	Афакия	\bафаки[а-я]*		
Африканский трипаносомоз	Африканский трипаносомоз	\bафриканск[а-я]+ трипаносомоз[а-я]*		
Афты	Афты	\bафт[а-я]*		
Аффективно-респираторные приступы	Аффективно-респираторные приступы	\bаффективно-респираторн[а-я]* приступ[а-я]*		
Аффективные расстройства	Аффективные расстройства	\bаффективн[а-я]* расстройств[а-я]*		
Ахалазия кардии	Ахалазия кардии	\bахалаз[а-я]+ карди[а-я]+		
Ахиллобурсит	Ахиллобурсит	\bахиллобурсит[а-я]*		
Ахлоргидрия	Ахлоргидрия	\bахлоргидри[а-я]+		
Ахолия	Ахолия	\bахоли[а-я]+		
Ахондроплазия	Ахондроплазия	\bахондроплази[а-я]+		
Ацерулоплазминемия	Ацерулоплазминемия	\bацерулоплазминеми[а-я]+		
Ацетонемический синдром у детей	Ацетонемический синдром у детей	\bацетонемическ[а-я]+ синдром[а-я]*( у детей)?		
Ацетонемия	Ацетонемия	\bацетонеми[а-я]+		
Ацефалия	Ацефалия	\bацефали[а-я]+		
Аэросинусит	Аэросинусит	\bаэросинусит[а-я]*		
Аэрофагия	Аэрофагия	\bаэрофаги[а-я]+		
Бабезиозы	Бабезиозы	\bбабезиоз[а-я]*		
Базалиома	Базалиома	\bбазалиом[а-я]*		
Бактериальный вагиноз	Бактериальный вагиноз	\bбактериальн[а-я]+ вагиноз[а-я]*		
Баланит	Баланит	\bбаланит[а-я]*		
Балантидиаз	Балантидиаз	\bбалантидиаз[а-я]*		
Барбитуризм	Барбитуризм	\bбарбитуризм[а-я]*		
Баротравма	Баротравма	\bбаротравм[а-я]*		
Бартолинит	Бартолинит	\bбартолинит[а-я]*		
Бартонеллёз	Бартонеллёз	\bбартонелл(ё|е)з[а-я]*		
Безоар	Безоар	\bбезоар[а-я]*		
Бели	Бели	\bбел[а-я]*		
Бери-бери	Бери-бери	\bбери-бери		
Бериллиоз	Бериллиоз	\bбериллиоз[а-я]*		
Бесплодие	Бесплодие	\bбесплоди[а-я]*		
Бессонница	Бессонница	\bбессонниц[а-я]*		
Бета-маннозидоз	Бета-маннозидоз	\bбета-маннозидоз[а-я]*		
Бешенство	Бешенство	\bбешенств[а-я]*		
Биназальная гемианопсия	Биназальная гемианопсия	\bбиназальн[а-я]+ гемианопси[а-я]+		
Биполярное аффективное расстройство	Биполярное аффективное расстройство	\bбиполярн[а-я]* аффективн[а-я]* расстройств[а-я]*		
Биполярное расстройство второго типа	Биполярное расстройство второго типа	\bбиполярн[а-я]* расстройств[а-я]* второго типа		
Битемпоральная гемианопсия	Битемпоральная гемианопсия	\bбитемпоральн[а-я]+ гемианопси[а-я]+		
Бластомикоз	Бластомикоз	\bбластомикоз[а-я]*		
Блефарит	Блефарит	\bблефар[а-я]*		
Близорукость	Близорукость	\b(близорук|миопи)[а-я]*		
Блокада ножек пучка Гиса	Блокада ножек пучка Гиса	\bблокада (нож[а-я]* пуч[а-я]* гис[а-я]*|сердц[а-я]*)		
Блуждающая почка	Блуждающая почка	\bблуждающ[а-я]* почк[а-я]+		
Боевая психическая травма	Боевая психическая травма	\bбоев[а-я]+ психическ[а-я]+ травм[а-я]*		
Боковой амиотрофический склероз	Боковой амиотрофический склероз	\bбоков[а-я]+ амиотрофическ[а-я]+ склероз[а-я]*		
Болезнь Адамантиадиса-Бехчета	Болезнь Адамантиадиса-Бехчета	\bболезн[а-я]* (Адамантиадиса-Бехчета|Аддисона|Александера|Альцгеймера|Андерсена|Баттена Бехтерева|Бильшовского-Янского|Боуэна|Брилля-Цинссера|Брутона|Верльгофа|Виллебранда|Вильсона-Коновалова|Вольмана|Галлервордена-Шпатца|Гентингтона|Герса|Гиппеля-Линдау|Гирке|Гиршпрунга|Горхема|Гоше|Гюнтера|Иценко-Кушинга|Коатса|Краббе|Крейтцфельдта-Якоба|Крона|Куфса|Кэнэвэн|Лайма|Мак-Ардля|Менетрие|Менкеса|Меньера|Минаматы|Моямоя|Ниманна-Пика|Огучи|Паркинсона|Пейрони|Пертеса|Пика|Помпе|Рандю-Ослера|Рейно|Сантавуори-Халтиа|Симмондса|Стилла|Таруи|Тея-Сакса|Уиппла|Унферрихта-Лундборга|Урбаха-Вите|Фабри|Фарбера|Форбса|Шагаса|Шамберга|Шарко-Мари-Тута|Шляттера|Штаргардта|Эрдгейма-Честера|полов[а-я]* акт[а-я]*)		
Большое депрессивное расстройство	Большое депрессивное расстройство	\bбольш[а-я]+ депрессивно[а-я]* расстройств[а-я]*		
Бородавка	Бородавка	\bбородавк[а-я]*		
Ботулизм	Ботулизм	\bботулизм[а-я]*		
Брадзот	Брадзот	\bбрадзот[а-я]*		
Брахидактилия	Брахидактилия	\bбрахидактили[а-я]+		
Брахиметатарзия	Брахиметатарзия	\bбрахиметатарзи[а-я]+		
Бредовое расстройство	Бредовое расстройство	\bбредовое расстройств[а-я]*		
Бридость	Бридость	\bбридост[а-я]*		
Бронхиальная астма	Бронхиальная астма	\bбронхиальн[а-я]+ астм[а-я]*		
Бронхиолоальвеолярный рак	Бронхиолоальвеолярный рак	\bбронхиолоальвеолярн[а-я]+ рак[а-я]*		
Бронхит	Бронхит	\bбронхит[а-я]*		
Бронхолёгочная дисплазия	Бронхолёгочная дисплазия	\bбронхол(ё|е)гочн[а-я]+ дисплази[а-я]+		
Бронхопневмония	Бронхопневмония	\bбронхопневмони[а-я]+		
Бронхоэктатическая болезнь	Бронхоэктатическая болезнь	\bбронхоэктатическ[а-я]+		
Бругиоз	Бругиоз	\bбругиоз[а-я]*		
Бруксизм	Бруксизм	\bбруксизм[а-я]*		
Бруцеллёз	Бруцеллёз	\bбруцелл(ё|е)з[а-я]*		
Брюшной тиф	Брюшной тиф	\bбрюшн[а-я]+ тиф[а-я]*		
Бубонная чума	Бубонная чума	\bбубонн[а-я]+ чум[а-я]+		
Буллёзная кератопатия	Буллёзная кератопатия	\bбулл(ё|е)зн[а-я]+ кератопати[а-я]*		
Буллёзный эпидермолиз	Буллёзный эпидермолиз	\bбулл(ё|е)зн[а-я]+ эпидермолиз[а-я]*		
Бульбит	Бульбит	\bбульбит[а-я]*		
Бурсит	Бурсит	\bбурсит[а-я]*		
Вагинизм	Вагинизм	\bвагинизм[а-я]*		
Варикозное расширение вен	Варикозное расширение вен	\bварикозно[а-я]* расширени[а-я]+ вен[а-я]*		
Варикоцеле	Варикоцеле	\bварикоцеле		
Васкулит	Васкулит	\bваскулит[а-я]*		
Венерическая лимфогранулёма	Венерическая лимфогранулёма	\bвенерическ[а-я]+ лимфогранул(ё|е)м[а-я]*		
Ветряная оспа	Ветряная оспа	\bветрян[а-я]+ осп[а-я]*		
Вибрационная болезнь	Вибрационная болезнь	\bвибрационн[а-я]+ болезн[а-я]+		
Вибриоз	Вибриоз	\bвибриоз[а-я]*		
Вирус Чикунгунья	Вирус Чикунгунья	\bвирус[а-я]* чикунгунь[а-я]*		
Вирусные заболевания	Вирусные заболевания	\bвирусн[а-я]* заболевани[а-я]+		
Височная эпилепсия	Височная эпилепсия	\bвисочн[а-я]+ эпилепси[а-я]+		
Вителиформная макулярная дистрофия	Вителиформная макулярная дистрофия	\bвителиформн[а-я]+ макулярн[а-я]+ дистрофи[а-я]+		
Витилиго	Витилиго	\bвитилиго		
ВИЧ-инфекция	ВИЧ-инфекция	\bвич-инфекци[а-я]+		
Внематочная беременность	Внематочная беременность	\bвнематочн[а-я]+ беременност[а-я]*		
Внутрибольничные инфекции	Внутрибольничные инфекции	\bвнутрибольничн[а-я]* инфекци[а-я]*		
Внутримозговое кровоизлияние	Внутримозговое кровоизлияние	\bвнутримозгов[а-я]* кровоизлияни[а-я]+		
Внутриутробная гипоксия	Внутриутробная гипоксия	\bвнутриутробн[а-я]+ гипокси[а-я]*		
Внутриутробные инфекции	Внутриутробные инфекции	\bвнутриутробн[а-я]* инфекци[а-я]*		
Внутричерепная гипертензия	Внутричерепная гипертензия	\bвнутричерепн[а-я]+ гипертензи[а-я]+		
Внутричерепное кровоизлияние	Внутричерепное кровоизлияние	\bвнутричерепно[а-я]* кровоизлияни[а-я]+		
Водянка сердца	Водянка сердца	\bводянк[а-я]* сердца		
Возвратный тиф	Возвратный тиф	\bвозвратн[а-я]+ тиф[а-я]*		
Волосяной лишай	Волосяной лишай	\bволосян[а-я]+ лиша[а-я]*		
Волынская лихорадка	Волынская лихорадка	\bволынск[а-я]+ лихорад[а-я]*		
Вольфартиоз	Вольфартиоз	\bвольфартиоз[а-я]*		
Восковидные липофусцинозы нейронов	Восковидные липофусцинозы нейронов	\bвосковидн[а-я]* липофусциноз[а-я]* нейрон[а-я]*		
Воспаление глазного нерва	Воспаление глазного нерва	\bвоспалени[а-я]+ глазн[а-я]* нерв[а-я]*		
Врождённая гиперплазия коры надпочечников	Врождённая гиперплазия коры надпочечников	\bврожд(ё|е)нн[а-я]+ гиперплаз[а-я]+ коры надпочечник[а-я]*		
Врождённая дистрофия стромы роговицы	Врождённая дистрофия стромы роговицы	\bврожд(ё|е)нн[а-я]+ дистроф[а-я]+ стромы роговиц[а-я]*		
Врождённая эндотелиальная дистрофия роговицы	Врождённая эндотелиальная дистрофия роговицы	\bврожд(ё|е)нн[а-я]+ эндотелиальн[а-я]+ дистроф[а-я]+ роговиц[а-я]*		
Врождённые пороки сердца	Врождённые пороки сердца	\bврожд(ё|е)нн[а-я]* поро[а-я]* сердца		
Врождённый гипотиреоз	Врождённый гипотиреоз	\bврожд(ё|е)нн[а-я]+ гипотиреоз[а-я]*		
Вуайеризм	Вуайеризм	\bвуайеризм[а-я]*		
Вульвит	Вульвит	\bвульвит[а-я]*		
Вульвовагинит	Вульвовагинит	\bвульвовагинит[а-я]*		
Вульводиния	Вульводиния	\bвульводини[а-я]+		
Вухерериоз	Вухерериоз	\bвухерериоз[а-я]*		
Вывих	Вывих	\bвывих[а-я]*( нижней челюсти| хрусталика)?		
Выворот век	Выворот век	\bвыворот[а-я]* век[а-я]*		
Выкидыш	Выкидыш	\bвыкидыш[а-я]*		
Выпадение прямой кишки	Выпадение прямой кишки	\bвыпадени[а-я]+ прямой кишки		
Высокофункциональный аутизм	Высокофункциональный аутизм	\bвысокофункциональн[а-я]+ аутизм[а-я]*		
Высотная болезнь	Высотная болезнь	\bвысотн[а-я]+ болезн[а-я]+		
Габронемоз	Габронемоз	\bгабронемоз[а-я]*		
Газовая эмболия	Газовая эмболия	\bгазов[а-я]+ эмболи[а-я]+		
Галактоземия	Галактоземия	\bгалактоземи[а-я]+		
Галакторея	Галакторея	\bгалактор[а-я]+		
Галлюциноз	Галлюциноз	\bгаллюциноз[а-я]*		
Гамазоидозы	Гамазоидозы	\bгамазоидоз[а-я]*		
Гамартома	Гамартома	\bгамартом[а-я]*		
Гамартома лёгкого	Гамартома лёгкого	\bгамартом[а-я]* л(ё|е)гк[а-я]+		
Ганглионеврит	Ганглионеврит	\bганглионеврит[а-я]*		
Гангрена	Гангрена	\bгангрен[а-я]*( газов[а-я]+| фурнье)?		
Гаргоилизм	Гаргоилизм	\bгаргоилизм[а-я]*		
Гаспинг-синдром	Гаспинг-синдром	\bгаспинг-синдром[а-я]*		
Гастрит	Гастрит	\bгастрит[а-я]*		
Гастродискоидоз	Гастродискоидоз	\bгастродискоидоз[а-я]*		
Гастродуоденит	Гастродуоденит	\bгастродуоденит[а-я]*		
Гастроинтестинальная стромальная опухоль	Гастроинтестинальная стромальная опухоль	\bгастроинтестинальн[а-я]+ стромальн[а-я]+ опухол[а-я]+		
Гастропарез	Гастропарез	\bгастропарез[а-я]*		
Гастрофилёз	Гастрофилёз	\bгастрофил(ё|е)з[а-я]*		
Гастрошизис	Гастрошизис	\bгастрошизис[а-я]*		
Гастроэзофагеальная рефлюксная болезнь	Гастроэзофагеальная рефлюксная болезнь	\bгастроэзофагеальн[а-я]+ рефлюксн[а-я]+ болезн[а-я]+		
Гастроэнтерит	Гастроэнтерит	\bгастроэнтерит[а-я]*		
Гастрэктомия	Гастрэктомия	\bгастрэктоми[а-я]+		
Гебефреническая шизофрения	Гебефреническая шизофрения	\bгебефреническ[а-я]+ шизофрени[а-я]+		
Гедоэльстиоз	Гедоэльстиоз	\bгедоэльстиоз[а-я]*		
Гелотофобия	Гелотофобия	\bгелотофоби[а-я]*		
Гельминтозы	Гельминтозы	\bгельминтоз[а-я]*		
Гельминты	Гельминты	\bгельминт[а-я]*		
Гемангиобластома	Гемангиобластома	\bгемангиобластом[а-я]*		
Гемангиома	Гемангиома	\bгемангиом[а-я]+		
Гемартроз	Гемартроз	\bгемартроз[а-я]*		
Гематома	Гематома	\bгематом[а-я]*		
Гематома носовой перегородки	Гематома носовой перегородки	\bгематом[а-я]* носовой перегородки		
Гематомиелия	Гематомиелия	\bгематомиели[а-я]+		
Гемиплегическая мигрень	Гемиплегическая мигрень	\bгемиплегическ[а-я]+ мигрен[а-я]*		
Гемиплегия	Гемиплегия	\bгемиплеги[а-я]+		
Гемифациальный спазм	Гемифациальный спазм	\bгемифациальн[а-я]+ спазм[а-я]*		
Гемобластозы	Гемобластозы	\bгемобластоз[а-я]*		
Гемоглобинурия	Гемоглобинурия	\bгемоглобинури[а-я]+		
Гемолитическая анемия	Гемолитическая анемия	\bгемолитическ[а-я]+ анеми[а-я]+		
Гемолитическая желтуха новорождённых	Гемолитическая желтуха новорождённых	\bгемолитическ[а-я]+ желтух[а-я]+( новорожд(ё|е)нных)?		
Гемонхоз	Гемонхоз	\bгемонхоз[а-я]*		
Геморрагическая болезнь новорождённых	Геморрагическая болезнь новорождённых	\bгеморрагическ[а-я]+( болезн[а-я]*( (у )?новорожд(ё|е)н[а-я]*)?| лихорадк[а-я]*| васкулит[а-я]*)		
Геморрой	Геморрой	\bгеморро[а-я]*		
Гемосидероз	Гемосидероз	\bгемосидероз[а-я]*		
Гемоторакс	Гемоторакс	\bгемоторакс[а-я]*		
Гемофилия	Гемофилия	\bгемофили[а-я]*( A| А| B| В| Б| C| С)?		
Гемофильная инфекция	Гемофильная инфекция	\bгемофильн[а-я]+ инфекци[а-я]+		
Гемохроматоз	Гемохроматоз	\bгемохроматоз[а-я]*		
Гендерная дисфория	Гендерная дисфория	\bгендерн[а-я]+ дисфори[а-я]+		
Гендерная неконформность	Гендерная неконформность	\bгендерн[а-я]+ неконформност[а-я]+		
Географический язык	Географический язык	\bгеографическ[а-я]+ язык[а-я]*		
Гепарин-индуцированная тромбоцитопения	Гепарин-индуцированная тромбоцитопения	\bгепарин-индуцированн[а-я]+ тромбоцитопени[а-я]+		
Гепатит	Гепатит	\bгепатит[а-я]*( A| А| B| В| Б| C| С| Д| Е| D| E)?		
Гепатобластома	Гепатобластома	\bгепатобластом[а-я]*		
Гепатоз	Гепатоз	\bгепатоз[а-я]*		
Гепаторенальный синдром	Гепаторенальный синдром	\bгепаторенальн[а-я]+ синдром[а-я]*		
Гепатоспленомегалия	Гепатоспленомегалия	\bгепатоспленомегали[а-я]+		
Гепатоцеллюлярная карцинома	Гепатоцеллюлярная карцинома	\bгепатоцеллюлярн[а-я]+ карцином[а-я]*		
Герметиоз	Герметиоз	\bгерметиоз[а-я]*		
Герпес	Герпес	\bгерпес[а-я]*		
Герпетический энцефалит	Герпетический энцефалит	\bгерпетическ[а-я]+ энцефалит[а-я]*		
Гестоз	Гестоз	\bгестоз[а-я]*		
Гетерофиоз	Гетерофиоз	\bгетерофиоз[а-я]*		
Гетерофория	Гетерофория	\bгетерофори[а-я]+		
Гетерохромия	Гетерохромия	\bгетерохроми[а-я]+		
Гигантизм	Гигантизм	\bгигантизм[а-я]*		
Гигантоклеточная опухоль	Гигантоклеточная опухоль	\bгигантоклеточн[а-я]+ опухол[а-я]*		
Гигрома	Гигрома	\bгигром[а-я]*		
Гидранэнцефалия	Гидранэнцефалия	\bгидранэнцефали[а-я]+		
Гидронефроз	Гидронефроз	\bгидронефроз[а-я]*		
Гидросальпинкс	Гидросальпинкс	\bгидросальпинкс[а-я]*		
Гидроторакс	Гидроторакс	\bгидроторакс[а-я]*		
Гидроцефалия	Гидроцефалия	\bгидроцефали[а-я]+		
Гименолепидоз	Гименолепидоз	\bгименолепидоз[а-я]*		
Гименоптеризм	Гименоптеризм	\bгименоптеризм[а-я]*		
Гингивит	Гингивит	\bгингивит[а-я]*		
Гиперальдостеронизм	Гиперальдостеронизм	\bгиперальдостеронизм[а-я]*		
Гипервитаминоз	Гипервитаминоз	\bгипервитаминоз[а-я]*		
Гипергидроз	Гипергидроз	\bгипергидроз[а-я]*		
Гипергликемия	Гипергликемия	\bгипергликеми[а-я]+		
Гиперестезия	Гиперестезия	\bгиперестези[а-я]+		
Гиперкальциемический криз	Гиперкальциемический криз	\bгиперкальциемическ[а-я]+ криз[а-я]*		
Гиперкальциемия	Гиперкальциемия	\bгиперкальциеми[а-я]+		
Гиперкапния	Гиперкапния	\bгиперкапни[а-я]+		
Гиперлексия	Гиперлексия	\bгиперлекси[а-я]*		
Гиперлипидемия	Гиперлипидемия	\bгиперлипидеми[а-я]+		
Гипернатриемия	Гипернатриемия	\bгипернатриеми[а-я]+		
Гиперосмолярная диабетическая кома	Гиперосмолярная диабетическая кома	\bгиперосмолярн[а-я]+ диабетическ[а-я]+ ком[а-я]*		
Гиперпаратиреоз	Гиперпаратиреоз	\bгиперпаратиреоз[а-я]*		
Гиперплазия	Гиперплазия	\bгиперплази[а-я]+		
Гиперсаливация	Гиперсаливация	\bгиперсаливаци[а-я]+		
Гиперсомния	Гиперсомния	\bгиперсомни[а-я]+		
Гипертелоризм	Гипертелоризм	\bгипертелоризм[а-я]*		
Гипертензивный церебральный криз	Гипертензивный церебральный криз	\bгипертензивн[а-я]+ церебральн[а-я]+ криз[а-я]*		
Гипертензия белых халатов	Гипертензия белых халатов	\bгипертенз[а-я]+ белых халатов		
Гипертермия	Гипертермия	\bгипертерми[а-я]+		
Гипертоническая ретинопатия	Гипертоническая ретинопатия	\bгипертоническ[а-я]+ ретинопати[а-я]*		
Гипертонический криз	Гипертонический криз	\bгипертоническ[а-я]+ криз[а-я]*		
Гипертрихоз	Гипертрихоз	\bгипертрихоз[а-я]*		
Гипертропия	Гипертропия	\bгипертропи[а-я]+		
Гипертрофическая кардиомиопатия	Гипертрофическая кардиомиопатия	\bгипертрофическ[а-я]+ кардиомиопати[а-я]+		
Гипертрофия	Гипертрофия	\bгипертроф[а-я]+( д(е|ё)сн(ы|ен))?		
Гиперурикемия	Гиперурикемия	\bгиперурикеми[а-я]+		
Гиперчувствительность	Гиперчувствительность	\bгиперчувствительност[а-я]+		
Гипоальдостеронизм	Гипоальдостеронизм	\bгипоальдостеронизм[а-я]*		
Гиповитаминоз	Гиповитаминоз	\bгиповитаминоз[а-я]*( A| D)?		
Гиповолемия	Гиповолемия	\bгиповолеми[а-я]+		
Гипогалактия	Гипогалактия	\bгипогалакти[а-я]+		
Гипогликемическая кома	Гипогликемическая кома	\bгипогликемическ[а-я]+ ком[а-я]*		
Гипогликемия	Гипогликемия	\bгипогликеми[а-я]+		
Гиподерматоз	Гиподерматоз	\bгиподерматоз[а-я]*		
Гипокалиемия	Гипокалиемия	\bгипокалиеми[а-я]+		
Гипокальциемический криз	Гипокальциемический криз	\bгипокальциемическ[а-я]+ криз[а-я]*		
Гипокальциемия	Гипокальциемия	\bгипокальциеми[а-я]+		
Гипокортицизм	Гипокортицизм	\bгипокортицизм[а-я]*		
Гиполибидемия	Гиполибидемия	\bгиполибидеми[а-я]+		
Гипомания	Гипомания	\bгипомани[а-я]+		
Гипоменорея	Гипоменорея	\bгипоменор[а-я]+		
Гипонатриемия	Гипонатриемия	\bгипонатриеми[а-я]+		
Гипопаратиреоз	Гипопаратиреоз	\bгипопаратиреоз[а-я]*		
Гипоплазия зубов	Гипоплазия зубов	\bгипоплаз[а-я]+ зуб[а-я]*		
Гипопротеинемия	Гипопротеинемия	\bгипопротеинеми[а-я]+		
Гипоспадия	Гипоспадия	\bгипоспади[а-я]*		
Гипоталамо-гипофизарная кома	Гипоталамо-гипофизарная кома	\bгипоталамо-гипофизарн[а-я]+ ком[а-я]*		
Гипотермия	Гипотермия	\bгипотерми[а-я]+		
Гипотиреоз	Гипотиреоз	\bгипотиреоз[а-я]*		
Гипофосфатазия	Гипофосфатазия	\bгипофосфатази[а-я]+		
Гирсутизм	Гирсутизм	\bгирсутизм[а-я]*		
Гистиоцитоз X	Гистиоцитоз X	\bгистиоцитоз[а-я]*( Х| X)?		
Гистоплазмоз	Гистоплазмоз	\bгистоплазмоз[а-я]*		
Гифема	Гифема	\bгифем[а-я]+		
Глазная мигрень	Глазная мигрень	\bглазн[а-я]+ мигрен[а-я]+		
Глаукома	Глаукома	\bглауком[а-я]*		
Гликогевзия	Гликогевзия	\bгликогевзи[а-я]+		
Гликогенозы	Гликогенозы	\bгликогеноз[а-я]*		
Глиобластома	Глиобластома	\bглиобластом[а-я]*		
Глиома	Глиома	\bглиом[а-я]*		
Глиоматоз головного мозга	Глиоматоз головного мозга	\bглиоматоз[а-я]* головно[а-я]+ мозг[а-я]*		
Гломерулонефрит	Гломерулонефрит	\bгломерулонефрит[а-я]*		
Гломусная опухоль уха	Гломусная опухоль уха	\bгломусн[а-я]+ опухол[а-я]+ у(х|ш)[а-я]*		
Глоссит	Глоссит	\bглоссит[а-я]*		
Глюкагонома	Глюкагонома	\bглюкагоном[а-я]*		
Гнатостомоз	Гнатостомоз	\bгнатостомоз[а-я]*		
Гноекровие	Гноекровие	\bгноекрови[а-я]+		
Головная боль	Головная боль	\bголовн[а-я]+ бол[а-я]*( тензионного типа)?		
Головной педикулёз	Головной педикулёз	\bголовн[а-я]+ педикул(ё|е)з[а-я]*		
Головокружение	Головокружение	\bголовокружени[а-я]+		
Гомонимная гемианопсия	Гомонимная гемианопсия	\bгомонимн[а-я]+ гемианопси[а-я]+		
Гонгилонематоз	Гонгилонематоз	\bгонгилонематоз[а-я]*		
Гонорея	Гонорея	\bгоноре[а-я]+		
Гранулематоз Вегенера	Гранулематоз Вегенера	\bгранулематоз[а-я]*( вегенера)?		
Гранулематозный простатит	Гранулематозный простатит	\bгранулематозн[а-я]+ простатит[а-я]*		
Гранулярная дистрофия роговицы I типа	Гранулярная дистрофия роговицы I типа	\bгранулярн[а-я]+ дистроф[а-я]+ роговицы( I[а-я]*| II[а-я]*| 1[а-я]*| 2[а-я]*| первого| второго) типа		
Грибковые кератиты	Грибковые кератиты	\bгрибков[а-я]* кератит[а-я]*		
Грипп	Грипп	\bгрипп[а-я]*		
Грыжа	Грыжа	\bгрыж[а-я]*( шморля)?		
Гумма	Гумма	\bгумм[а-я]*		
Дакриоаденит	Дакриоаденит	\bдакриоаденит[а-я]*		
Дальнозоркость	Дальнозоркость	\bдальнозоркост[а-я]+		
Дальтонизм	Дальтонизм	\bдальтонизм[а-я]*		
ДВС-синдром	ДВС-синдром	\bдвс-синдром[а-я]*		
Дебильность	Дебильность	\bдебильност[а-я]+		
Дегенеративно-дистрофическое заболевание диска	Дегенеративно-дистрофическое заболевание диска	\bдегенеративно-дистрофическ[а-я]+ заболевани[а-я]* диск[а-я]*		
Дейтеранопия	Дейтеранопия	\bдейтеранопи[а-я]+		
Декомпрессионная болезнь	Декомпрессионная болезнь	\bдекомпрессионн[а-я]+ болезн[а-я]+		
Декстрокардия	Декстрокардия	\bдекстрокарди[а-я]+		
Делирий	Делирий	\bделири[а-я]+		
Деменция	Деменция	\bдеменци[а-я]+		
Деменция с тельцами Леви	Деменция с тельцами Леви	\bдеменц[а-я]+ с тельцами леви		
Демиелинизация	Демиелинизация	\bдемиелинизаци[а-я]+		
Демиелинизирующие заболевания	Демиелинизирующие заболевания	\bдемиелинизирующ[а-я]+ заболевани[а-я]+		
Демодекоз	Демодекоз	\bдемодекоз[а-я]*		
Демодекоз собак	Демодекоз собак	\bдемодекоз[а-я]*( собак)?		
Демпинг-синдром	Демпинг-синдром	\bдемпинг-синдром[а-я]*		
Лихорадка денге	Лихорадка денге	\bлихорадк[а-я]+ денге		
Депрессия	Депрессия	\bдепресси[а-я]*		
Дерманиссиоз	Дерманиссиоз	\bдерманиссиоз[а-я]*		
Дерматит	Дерматит	\bдерматит[а-я]*		
Дерматит жуков-нарывников	Дерматит жуков-нарывников	\bдерматит[а-я]* жуков-нарывников		
Дерматобиаз	Дерматобиаз	\bдерматобиаз[а-я]*		
Дерматоз	Дерматоз	\bдерматоз[а-я]*		
Дерматозойный бред	Дерматозойный бред	\bдерматозойн[а-я]+ бред[а-я]*		
Дерматомиозит	Дерматомиозит	\bдерматомиозит[а-я]*		
Дерматофагоидоз	Дерматофагоидоз	\bдерматофагоидоз[а-я]*		
Дерматофилиазы	Дерматофилиазы	\bдерматофилиаз[а-я]*		
Дермацентороз	Дермацентороз	\bдермацентороз[а-я]*		
Дермографизм	Дермографизм	\bдермографизм[а-я]*		
Дермоидная киста	Дермоидная киста	\bдермоидн[а-я]+ кист[а-я]+		
Десмоид	Десмоид	\bдесмоид[а-я]*		
Детская розеола	Детская розеола	\bдетск[а-я]+ (розеол[а-я]*|тип[а-я]* шизофрении|церебральн[а-я]+ паралич[а-я]*|дезинтегративн[а-я]+ расстройств[а-я]+)		
Дефект межжелудочковой перегородки	Дефект межжелудочковой перегородки	\bдефект[а-я]* меж(предсердн|желудочков)[а-я]+ перегородки		
Дефицит 1α-гидроксилазы	Дефицит 1α-гидроксилазы	\bдефицит[а-я]* 1(α|а)-гидроксилазы		
Дефицит 5-альфа-редуктазы	Дефицит 5-альфа-редуктазы	\bдефицит[а-я]* (5|пять)-альфа-редуктазы		
Дефицит селена	Дефицит селена	\bдефицит[а-я]* селена		
Джетлаг	Джетлаг	\bджетлаг[а-я]*		
Диабетическая ангиопатия	Диабетическая ангиопатия	\bдиабетическ[а-я]+ ((ангио|(поли)?не(й|ф)ро|ретино)пати|ком)[а-я]+		
Диарея	Диарея	\bдиаре[а-я]+		
Дизартрия	Дизартрия	\bдизартри[а-я]+		
Дизентерия	Дизентерия	\bдизентери[а-я]+		
Дикроцелиоз	Дикроцелиоз	\bдикроцелиоз[а-я]*		
Дилатационная кардиомиопатия	Дилатационная кардиомиопатия	\bдилатационн[а-я]+ кардиомиопати[а-я]*		
Дилатация предсердий	Дилатация предсердий	\bдилатац[а-я]+ предсерд[а-я]*		
Дипилидиоз	Дипилидиоз	\bдипилидиоз[а-я]*		
Диплопия	Диплопия	\bдиплопи[а-я]+		
Диптерозы	Диптерозы	\bдиптероз[а-я]*		
Дирофиляриоз	Дирофиляриоз	\bдирофиляриоз[а-я]*		
Дисбактериоз	Дисбактериоз	\bдисбактериоз[а-я]*		
Дисгидроз	Дисгидроз	\bдисгидроз[а-я]*		
Дисграфия	Дисграфия	\bдисграфи[а-я]+		
Дискинезия желчевыводящих путей	Дискинезия желчевыводящих путей	\bдискинез[а-я]+ желчевыводящих путей		
Дискинезия пищевода	Дискинезия пищевода	\bдискинез[а-я]+ пищевода		
Дисменорея	Дисменорея	\bдисменор[а-я]+		
Дисморфомания	Дисморфомания	\bдисморфомани[а-я]+		
Дисморфофобия	Дисморфофобия	\bдисморфофоби[а-я]+		
Диспепсия	Диспепсия	\bдиспепси[а-я]+		
Дисплазия соединительной ткани	Дисплазия соединительной ткани	\bдисплаз[а-я]+ соединительн[а-я]* ткан[а-я]*		
Дисплазия тазобедренного сустава	Дисплазия тазобедренного сустава	\bдисплаз[а-я]+ тазобедрен[а-я]* сустав[а-я]*		
Дисплазия шейки матки	Дисплазия шейки матки	\bдисплаз[а-я]+ шейки матки		
Диссоциальное расстройство личности	Диссоциальное расстройство личности	\bдиссоциально[а-я]* расстройств[а-я]* личности		
Диссоциативная амнезия	Диссоциативная амнезия	\bдиссоциативн[а-я]+ амнези[а-я]+		
Диссоциативная фуга	Диссоциативная фуга	\bдиссоциативн[а-я]+ фуг[а-я]*		
Диссоциативное расстройство идентичности	Диссоциативное расстройство идентичности	\bдиссоциативно[а-я]* расстройств[а-я]* идентичности		
Диссоциативные конвульсии	Диссоциативные конвульсии	\bдиссоциативн[а-я]* конвульси[а-я]*		
Диссоциативные расстройства	Диссоциативные расстройства	\bдиссоциативн[а-я]* расстройств[а-я]*		
Дистимия	Дистимия	\bдистими[а-я]+		
Дистихиаз	Дистихиаз	\bдистихиаз[а-я]*		
Дистрофия базальной мембраны эпителия	Дистрофия базальной мембраны эпителия	\bдистрофи[а-я]+( базальной мембраны эпителия| боуменовой мембраны ((I[а-я]*|II[а-я]*|1[а-я]*|2[а-я]*|первого|второго) типа)?| колбочек| роговицы( авеллино| греноува| лиша| месманна| рейса-бюклерса| тиля-бенке| шнайдера)?)		
Дисфункция сфинктера Одди	Дисфункция сфинктера Одди	\bдисфункц[а-я]+ сфинктера одди		
Дифаллия	Дифаллия	\bдифалли[а-я]+		
Дифиллоботриоз	Дифиллоботриоз	\bдифиллоботриоз[а-я]*		
Дифтерия	Дифтерия	\bдифтери[а-я]+		
Диффузное аксональное повреждение головного мозга	Диффузное аксональное повреждение головного мозга	\bдиффузно[а-я]* аксонально[а-я]* повреждени[а-я]+ головного мозга		
Диффузный спазм пищевода	Диффузный спазм пищевода	\bдиффузн[а-я]+ спазм[а-я]* пищевод[а-я]*		
Диффузный токсический зоб	Диффузный токсический зоб	\bдиффузн[а-я]+ токсическ[а-я]+ зоб[а-я]*		
Длительное расстройство восприятия, вызванное галлюциногенами	Длительное расстройство восприятия, вызванное галлюциногенами	\bдлительно[а-я]* расстройств[а-я]* восприятия(,)? вызванно[а-я]* галлюциноген[а-я]*		
Дневная слепота	Дневная слепота	\bдневн[а-я]+ слепот[а-я]+		
Доброкачественная гиперплазия предстательной железы	Доброкачественная гиперплазия предстательной железы	\bдоброкачественн[а-я]+ гиперплаз[а-я]+ предстательной железы		
Доброкачественное позиционное пароксизмальное головокружение	Доброкачественное позиционное пароксизмальное головокружение	\bдоброкачественно[а-я]* позиционно[а-я]* пароксизмально[а-я]* головокружени[а-я]+		
Долихоколон	Долихоколон	\bдолихоколон[а-я]*		
Долихосигма	Долихосигма	\bдолихосигм[а-я]+		
Дракункулёз	Дракункулёз	\bдракункул(ё|е)з[а-я]*		
Дранкорексия	Дранкорексия	\bдранкорекси[а-я]+		
Дромомания	Дромомания	\bдромомани[а-я]+		
Друзы оптического диска	Друзы оптического диска	\bдруз[а-я]+ оптического диска		
Дуга аорты	Дуга аорты	\bдуг[а-я]+ аорты		
Дуоденит	Дуоденит	\bдуоденит[а-я]*		
Дыхательная недостаточность	Дыхательная недостаточность	\bдыхательн[а-я]+ недостаточност[а-я]+		
Евроглифоз	Евроглифоз	\bевроглифоз[а-я]*		
Желатинозная каплевидная дистрофия роговицы	Желатинозная каплевидная дистрофия роговицы	\bжелатиноз[а-я]*н[а-я]+ каплевидн[а-я]+ дистроф[а-я]+ роговиц[а-я]*		
Железодефицитная анемия	Железодефицитная анемия	\bжелезодефицитн[а-я]+ анеми[а-я]+		
Жёлтая лихорадка	Жёлтая лихорадка	\bж(ё|е)лт[а-я]+ лихорадк[а-я]+		
Желтуха	Желтуха	\bжелтух[а-я]+		
Жёлчнокаменная болезнь	Жёлчнокаменная болезнь	\bж(ё|е)лчнокаменн[а-я]+ болезн[а-я]+		
Заболевания сердца	Заболевания сердца	\bзаболеван[а-я]+ сердца		
Заболевания, передающиеся половым путём	Заболевания, передающиеся половым путём	\bзаболевани[а-я]+, передающе[а-я]+ половым пут(ё|е)м		
Зависимое расстройство личности	Зависимое расстройство личности	\bзависим[а-я]+ расстройств[а-я]* личности		
Заглоточный абсцесс	Заглоточный абсцесс	\bзаглоточн[а-я]+ абсцесс[а-я]*		
Задняя аморфная дистрофия роговицы	Задняя аморфная дистрофия роговицы	\bзадн[а-я]+ аморфн[а-я]+ дистроф[а-я]+ роговицы (тип(1|2|3))?		
Заеда	Заеда	\bзаед[а-я]*		
Заикание	Заикание	\bзаикани[а-я]+		
Лихорадка Западного Нила	Лихорадка Западного Нила	\bлихорадк[а-я]* западного нила		
Запор	Запор	\bзапор[а-я]*		
Затёк	Затёк	\bзат(ё|е)к[а-я]*		
Зерновая чесотка	Зерновая чесотка	\bзернов[а-я]+ чесотк[а-я]*		
Злокачественная гипертермия	Злокачественная гипертермия	\bзлокачественн[а-я]+ гипертерми[а-я]+		
Злокачественная опухоль	Злокачественная опухоль	\bзлокачественн[а-я]+ опухол[а-я]*		
Злокачественные новообразования яичка	Злокачественные новообразования яичка	\bзлокачественн[а-я]* новообразован[а-я]+ яичк[а-я]*		
Злокачественные опухоли полости рта	Злокачественные опухоли полости рта	\bзлокачественн[а-я]* опухол[а-я]* полости рта		
Злокачественный нейролептический синдром	Злокачественный нейролептический синдром	\bзлокачественн[а-я]+ нейролептическ[а-я]+ синдром[а-я]*		
Змеиный клещевой дерматит	Змеиный клещевой дерматит	\bзмеин[а-я]+ клещев[а-я]+ дерматит[а-я]*		
Зоб	Зоб	\bзоб[а-я]*		
Зоонозы	Зоонозы	\bзооноз[а-я]*		
Зоофилия	Зоофилия	\bзоофили[а-я]+		
Зрачок Аргайл Робетсон	Зрачок Аргайл Робетсон	\bзрач(ок|ки) (марка ганна|аргайл робетсон)		
Зубная боль	Зубная боль	\bзубн[а-я]+ бол[а-я]*		
Идиопатическая гиперсомния	Идиопатическая гиперсомния	\bидиопатическ[а-я]+ гиперсомни[а-я]*		
Идиопатическая кальцификация базальных ганглиев 1	Идиопатическая кальцификация базальных ганглиев 1	\bидиопатическ[а-я]+ кальцификаци[а-я]* базальн[а-я]* гангли[а-я]*( 1)?		
Идиопатический фиброзирующий альвеолит	Идиопатический фиброзирующий альвеолит	\bидиопатическ[а-я]+ фиброзирующ[а-я]* альвеолит[а-я]*		
Идиотия	Идиотия	\bидиоти[а-я]*		
Извращение вкуса	Извращение вкуса	\bизвращени[а-я]+ вкуса		
Изменения органов и систем при сахарном диабете	Изменения органов и систем при сахарном диабете	\bизменен[а-я]+( (органов|систем)( при сахарном диабете)?)		
Изоспороз	Изоспороз	\bизоспороз[а-я]*		
Иксодиоз	Иксодиоз	\bиксодиоз[а-я]*		
Имбецильность	Имбецильность	\bимбецильност[а-я]*		
Иммунодефицит	Иммунодефицит	\bиммунодефицит[а-я]*		
Импетиго	Импетиго	\bимпетиго		
Импульсивное расстройство личности	Импульсивное расстройство личности	\bимпульсивно[а-я]* расстройств[а-я]* личности		
Инвагинация кишечника	Инвагинация кишечника	\bинвагинац[а-я]+ кишечника		
Индуцированное бредовое расстройство	Индуцированное бредовое расстройство	\bиндуцированно[а-я]* бредов[а-я]+ расстройств[а-я]*		
Инсулинома	Инсулинома	\bинсулином[а-я]*		
Инсулинорезистентность	Инсулинорезистентность	\bинсулинорезистентност[а-я]*		
Инсулома	Инсулома	\bинсулом[а-я]*		
Инсульт	Инсульт	\bинсульт[а-я]*		
Интенционный тремор	Интенционный тремор	\bинтенционн[а-я]+ тремор[а-я]*		
Интерстициальные заболевания лёгких	Интерстициальные заболевания лёгких	\bинтерстициальн[а-я]* заболеван[а-я]+ л(ё|е)гких		
Инфаркт миокарда	Инфаркт миокарда	\bинфаркт[а-я]* миокарда		
Инфекционно-токсический шок	Инфекционно-токсический шок	\bинфекционно-токсическ[а-я]+ шок[а-я]*		
Инфекционные заболевания	Инфекционные заболевания	\bинфекционн[а-я]+ заболевани[а-я]+		
Инфекционный мононуклеоз	Инфекционный мононуклеоз	\bинфекционн[а-я]+ мононуклеоз[а-я]*		
Инфекционный эндокардит	Инфекционный эндокардит	\bинфекционн[а-я]+ эндокардит[а-я]*		
Ипохондрическая шизофрения	Ипохондрическая шизофрения	\bипохондрическ[а-я]+ шизофрени[а-я]*		
Иридодиализ	Иридодиализ	\bиридодиализ[а-я]*		
Иридоциклит	Иридоциклит	\bиридоциклит[а-я]*		
Искривление перегородки носа	Искривление перегородки носа	\bискривлени[а-я]+ перегородки носа		
Истерическое расстройство личности	Истерическое расстройство личности	\bистерическ[а-я]+ расстройств[а-я]* личности		
Истерия	Истерия	\bистери[а-я]+		
Истинная полицитемия	Истинная полицитемия	\bистинн[а-я]+ полицитеми[а-я]+		
Ихтиоз	Ихтиоз	\bихтиоз[а-я]*		
Ишемическая болезнь сердца	Ишемическая болезнь сердца	\bишемическ[а-я]*( болезн[а-я]* сердца| оптическ[а-я]* нейропати[а-я]* (задн|передняя)[а-я]*| инсульт[а-я]*)		
Камни предстательной железы	Камни предстательной железы	\bкам(ень|ни) предстательной железы		
Кампилобактериоз	Кампилобактериоз	\bкампилобактериоз[а-я]*		
Кандидоз	Кандидоз	\bкандидоз[а-я]*		
Канцероматоз мозговых оболочек	Канцероматоз мозговых оболочек	\bканцероматоз[а-я]* мозгов[а-я]+ оболоч[а-я]+		
Капилляропатия	Капилляропатия	\bкапилляропати[а-я]*		
Карбункул	Карбункул	\bкарбункул[а-я]*		
Кардиалгический синдром	Кардиалгический синдром	\bкардиалгическ[а-я]+ синдром[а-я]*		
Кардиогенный шок	Кардиогенный шок	\bкардиогенн[а-я]+ шок[а-я]*		
Кардиомиопатия	Кардиомиопатия	\bкардиомиопат[а-я]+( такоцубо)?		
Кардиопротезный психопатологический синдром	Кардиопротезный психопатологический синдром	\bкардиопротезн[а-я]+ психопатологическ[а-я]+ синдром[а-я]*		
Кариес зубов	Кариес зубов	\bкариес[а-я]*( зубов)?		
Карлик	Карлик	\bкарлик[а-я]*		
Карпоглифусиоз	Карпоглифусиоз	\bкарпоглифусиоз[а-я]*		
Карциноидный синдром	Карциноидный синдром	\bкарциноидн[а-я]+ синдром[а-я]*		
Карцинома	Карцинома	\bкарцином[а-я]*		
Карцинома эндометрия	Карцинома эндометрия	\bкарцинома эндометри[а-я]+		
Катаплексия	Катаплексия	\bкатаплекси[а-я]+		
Катаракта	Катаракта	\bкатаракт[а-я]*		
Кататоническая шизофрения	Кататоническая шизофрения	\bкататоническ[а-я]+ шизофрени[а-я]*		
Кахексия	Кахексия	\bкахекси[а-я]+		
Квадрантанопия	Квадрантанопия	\bквадрантанопи[а-я]+		
Квашиоркор	Квашиоркор	\bквашиоркор[а-я]*		
Келоид	Келоид	\bкелоид[а-я]*		
Кератит	Кератит	\bкератит[а-я]*		
Кератоглобус	Кератоглобус	\bкератоглобус[а-я]*		
Кератоконус	Кератоконус	\bкератоконус[а-я]*		
Кератоконъюнктивит	Кератоконъюнктивит	\bкератоконъюнктивит[а-я]*		
Кератолиз	Кератолиз	\bкератолиз[а-я]*		
Кератомаляция	Кератомаляция	\bкератомляци[а-я]+		
Кетоацидоз	Кетоацидоз	\bкетоацидоз[а-я]*		
Кивательный синдром	Кивательный синдром	\bкивательн[а-я]+ синдром[а-я]*		
Кислородное отравление	Кислородное отравление	\bкислородно[а-я]* отравлени[а-я]+		
Киста	Киста	\bкист[а-я]*( бейкера |ж(ё|е)лтого тела| поджелудочной железы| холедоха| яичника)?		
Кифоз	Кифоз	\bкифоз[а-я]*		
Кифосколиоз	Кифосколиоз	\bкифосколиоз[а-я]*		
Кишечный каппиляриоз	Кишечный каппиляриоз	\bкишечн[а-я]+ каппиляриоз[а-я]*		
Кишечный миаз	Кишечный миаз	\bкишечн[а-я]+ миаз[а-я]*		
Кластерные головные боли	Кластерные головные боли	\bкластерн[а-я]* головн[а-я]* бол[а-я]*		
Клептомания	Клептомания	\bклептомани[а-я]+		
Клетки Гюртле	Клетки Гюртле	\bклетк[а-я]* гюртле		
Клещевая сенсибилизация	Клещевая сенсибилизация	\bклещев[а-я]+ сенсибилизаци[а-я]+		
Клещевой паралич	Клещевой паралич	\bклещев[а-я]+ паралич[а-я]*		
Клещевой энцефалит	Клещевой энцефалит	\bклещев[а-я]+ энцефалит[а-я]*		
Клещевые инфекции	Клещевые инфекции	\bклещев[а-я]+ инфекци[а-я]+		
Клинодактилия	Клинодактилия	\bклинодактили[а-я]+		
Клипирование аневризмы	Клипирование аневризмы	\bклипировани[а-я]+ аневризм[а-я]*		
Клиторомегалия	Клиторомегалия	\bклиторомегали[а-я]+		
Клонорхоз	Клонорхоз	\bклонорхоз[а-я]*		
Ключично-черепной дизостоз	Ключично-черепной дизостоз	\bключично-черепн[а-я]+ дизостоз[а-я]*		
Коагулопатия	Коагулопатия	\bкоагулопати[а-я]*		
Коарктация аорты	Коарктация аорты	\bкоарктац[а-я]+ аорты		
Ковыряние в носу	Ковыряние в носу	\bковыряни[а-я]+ в носу		
Кожная аутосенсибилизация	Кожная аутосенсибилизация	\bкожн[а-я]+ аутосенсибилизаци[а-я]+		
Кожная мозоль	Кожная мозоль	\bкожн[а-я]+ мозол[а-я]+		
Кожный миаз	Кожный миаз	\bкожн[а-я]+ миаз[а-я]*		
Коклюш	Коклюш	\bкоклюш[а-я]*		
Кокцигодиния	Кокцигодиния	\bкокцигодин[а-я]+		
Кокцидиоз	Кокцидиоз	\bкокцидиоз[а-я]*		
Колеоптерозы	Колеоптерозы	\bколеоптероз[а-я]*		
Колит	Колит	\bколит[а-я]*		
Колоректальный рак	Колоректальный рак	\bколоректальн[а-я]+ рак[а-я]*		
Колотая рана	Колотая рана	\bколот[а-я]* ран[а-я]*		
Колото-резаная рана	Колото-резаная рана	\bколото-резан[а-я]+ ран[а-я]*		
Колтун (воспаление)	Колтун (воспаление)	\b(колтун[а-я]*|воспалени[а-я]+)		
Кольпит	Кольпит	\bкольпит[а-я]*		
Комедон	Комедон	\bкомедон[а-я]*		
Коммуникативное расстройство	Коммуникативное расстройство	\bкоммуникативн[а-я]* расстройств[а-я]*		
Комплекс неполноценности	Комплекс неполноценности	\bкомплекс[а-я]* неполноценност[а-я]+		
Кондуктивная тугоухость	Кондуктивная тугоухость	\bкондуктивн[а-я]* тугоухост[а-я]+		
Контагиозный моллюск	Контагиозный моллюск	\bконтагиоз[а-я]* моллюск[а-я]+		
Контактный дерматит	Контактный дерматит	\bконтактн[а-я]+ дерматит[а-я]*		
Контрактура	Контрактура	\bконтрактур[а-я]+( дюпюитрена)?		
Контрафобия	Контрафобия	\bконтрафоби[а-я]+		
Контузия	Контузия	\bконтузи[а-я]+		
Концентрический склероз Бало	Концентрический склероз Бало	\bконцентрическ[а-я]+ склероз[а-я]* бало		
Конъюнктивит	Конъюнктивит	\bконъюнктивит[а-я]*		
Кордилобиоз	Кордилобиоз	\bкордилобиоз[а-я]*		
Коронарная недостаточность	Коронарная недостаточность	\bкоронарн[а-я]+ недостаточност[а-я]*		
Короткая уздечка языка	Короткая уздечка языка	\bкоротк[а-я]+ уздечк[а-я]+ язык[а-я]*		
Кортикобазальная дегенерация	Кортикобазальная дегенерация	\bкортикобазальн[а-я]+ дегенераци[а-я]+		
Корь	Корь	\bкор(ь|и)?[а-я]*		
Косоглазие	Косоглазие	\bкосоглаз[а-я]*		
Косолапость	Косолапость	\bкосолапост[а-я]+		
Косорукость	Косорукость	\bкосорукост[а-я]+		
Костная резорбция	Костная резорбция	\bкостн[а-я]+ резорбци[а-я]+		
Кошмар	Кошмар	\bкошмар[а-я]*		
Крайняя степень ожирения с альвеолярной гиповентиляцией	Крайняя степень ожирения с альвеолярной гиповентиляцией	\bкрайн[а-я]* степен[а-я]* ожирен[а-я]+( с альвеолярн[а-я]+ гиповентиляци[а-я]*)?		
Краниосиностоз	Краниосиностоз	\bкраниосиностоз[а-я]*		
Краниофарингиома	Краниофарингиома	\bкраниофарингиом[а-я]+		
Крапивница	Крапивница	\bкрапивниц[а-я]+		
Крапчатая дистрофия роговицы	Крапчатая дистрофия роговицы	\bкрапчат[а-я]* дистрофи[а-я]+ роговиц[а-я]*		
Краснуха	Краснуха	\bкраснух[а-я]+		
Крауроз вульвы	Крауроз вульвы	\bкрауроз[а-я]*( вульвы)?		
Кретинизм	Кретинизм	\bкретинизм[а-я]*		
Кривошея	Кривошея	\bкривоше[а-я]+		
Криптококкоз	Криптококкоз	\bкриптококкоз[а-я]*		
Крипторхизм	Крипторхизм	\bкрипторхизм[а-я]*		
Криптоспоридиоз	Криптоспоридиоз	\bкриптоспоридиоз[а-я]*		
Криптофтальм	Криптофтальм	\bкриптофтальм[а-я]*		
Кристаллическая дистрофия Bietti	Кристаллическая дистрофия Bietti	\bкристаллическ[а-я]+ дистрофи[а-я]*( Би(е|э)(т|тт)и|Bietti)?		
Кровоизлияние в сетчатку	Кровоизлияние в сетчатку	\bкровоизли[а-я]+ в сетчатку		
Кровоизлияние в стекловидное тело	Кровоизлияние в стекловидное тело	\bкровоизли[а-я]+ в стекловидное тело		
Кровотечение	Кровотечение	\bкровотечени[а-я]+		
Кровотечение в раннем послеродовом периоде	Кровотечение в раннем послеродовом периоде	\bкровотечени[а-я]+ в раннем послеродовом периоде		
Круп	Круп	\bкруп[а-я]*		
Геморрагическая лихорадка Крым-Конго	Геморрагическая лихорадка Крым-Конго	\bгеморрагическ[а-я]+ лихорадк[а-я]* крым-конго		
Ксантелазма	Ксантелазма	\bксантелазм[а-я]*		
Ксантогранулематозный пиелонефрит	Ксантогранулематозный пиелонефрит	\bксантогранулематозн[а-я]+ пиелонефрит[а-я]*		
Ксеродерма	Ксеродерма	\bксеродерм[а-я]*		
Ксерофтальмия	Ксерофтальмия	\bксерофтальми[а-я]+		
Ку-лихорадка	Ку-лихорадка	\bку-лихорадк[а-я]*		
Куперит	Куперит	\bкуперит[а-я]*		
Куру (болезнь)	Куру (болезнь)	\bкуру		
Кутереброз	Кутереброз	\bкутереброз[а-я]*		
Лабиринтит	Лабиринтит	\bлабиринтит[а-я]*		
Лагофтальм	Лагофтальм	\bлагофтальм[а-я]*		
Лактостаз	Лактостаз	\bлактостаз[а-я]*		
Лихорадка Ласса	Лихорадка Ласса	\bлихорадк[а-я]* ласса		
Лата (синдром)	Лата (синдром)	\bлат[а-я]*		
Латентная шизофрения	Латентная шизофрения	\bлатентн[а-я]+ шизофрени[а-я]+		
Латентный туберкулёз	Латентный туберкулёз	\bлатентн[а-я]+ туберкул(ё|е)з[а-я]*		
Латиризм	Латиризм	\bлатиризм[а-я]*		
Латродектизм	Латродектизм	\bлатродектизм[а-я]*		
Легионеллёз	Легионеллёз	\bлегионелл(ё|е)з[а-я]*		
Лёгочная гипертензия	Лёгочная гипертензия	\bл(ё|е)гочн[а-я]+ гипертензи[а-я]+		
Лёгочное сердце	Лёгочное сердце	\bл(ё|е)гочно[а-я]* сердц[а-я]*		
Лейкоз	Лейкоз	\bлейкоз[а-я]*		
Лейкопения	Лейкопения	\bлейкопени[а-я]+		
Лейкоплакия	Лейкоплакия	\bлейкоплаки[а-я]*		
Лейкоцитоз	Лейкоцитоз	\bлейкоцитоз[а-я]*		
Лейциноз	Лейциноз	\bлейциноз[а-я]*		
Лейшманиоз	Лейшманиоз	\bлейшманиоз[а-я]*		
Висцеральный лейшманиоз	Висцеральный лейшманиоз	\bвисцеральн[а-я]+ лейшманиоз[а-я]*		
Кожный лейшманиоз	Кожный лейшманиоз	\bкожн[а-я]+ лейшманиоз[а-я]*		
Ленточная кератопатия	Ленточная кератопатия	\bленточн[а-я]+ кератопати[а-я]*		
Лепра	Лепра	\bлепр[а-я]*		
Лептоспироз	Лептоспироз	\bлептоспироз[а-я]*		
Летаргический энцефалит	Летаргический энцефалит	\bлетаргическ[а-я]+ энцефалит[а-я]*		
Лизосомные болезни накопления	Лизосомные болезни накопления	\bлизосомн[а-я]* болезн[а-я]* накоплени[а-я]+		
Лимитированная склеродермия	Лимитированная склеродермия	\bлимитированн[а-я]+ склеродерми[а-я]+		
Лимфангиолейомиоматоз	Лимфангиолейомиоматоз	\bлимфангиолейомиоматоз[а-я]*		
Лимфангиома	Лимфангиома	\bлимфангиом[а-я]*		
Лимфангиосаркома	Лимфангиосаркома	\bлимфангиосарком[а-я]*		
Лимфангит	Лимфангит	\bлимфангит[а-я]*		
Лимфогранулематоз	Лимфогранулематоз	\bлимфогранулематоз[а-я]*		
Лимфома	Лимфома	\bлимфом[а-я]*		
Лимфома Бёркитта	Лимфома Бёркитта	\bлимфом[а-я]* б(ё|е)ркитта		
Лимфостаз	Лимфостаз	\bлимфостаз[а-я]*		
Лимфоцитоз	Лимфоцитоз	\bлимфоцитоз[а-я]*		
Лингватулёз	Лингватулёз	\bлингватул(ё|е)з[а-я]*		
Липодистрофия	Липодистрофия	\bлиподистрофи[а-я]+		
Липоидная врождённая гиперплазия надпочечников	Липоидная врождённая гиперплазия надпочечников	\bлипоидн[а-я]+ врожд(ё|е)нн[а-я]+ гиперплаз[а-я]+ надпочечник[а-я]*		
Липома	Липома	\bлипом[а-я]*		
Липомеланотический ретикулёз	Липомеланотический ретикулёз	\bлипомеланотическ[а-я]+ ретикул(ё|е)з[а-я]*		
Липосаркома	Липосаркома	\bлипосарком[а-я]*		
Лиссэнцефалия	Лиссэнцефалия	\bлиссэнцефали[а-я]+		
Листериоз	Листериоз	\bлистериоз[а-я]*		
Литейная лихорадка	Литейная лихорадка	\bлитейн[а-я]+ лихорадк[а-я]*		
Литопедион	Литопедион	\bлитопедион[а-я]*		
Лихорадка Зика	Лихорадка Зика	\bлихорадк[а-я]* (зика|неясного генеза|от кошачьих царапин)		
Лоаоз	Лоаоз	\bлоаоз[а-я]*		
Локализованная склеродермия	Локализованная склеродермия	\bлокализованн[а-я]+ склеродерми[а-я]+		
Лордоз	Лордоз	\bлордоз[а-я]*		
Лудомания	Лудомания	\bлудомани[а-я]+		
Лучевая болезнь	Лучевая болезнь	\bлучев[а-я]+ болезн[а-я]+		
Люмбаго	Люмбаго	\bлюмбаго		
Лямблиоз	Лямблиоз	\bлямблиоз[а-я]*		
Мадароз	Мадароз	\bмадароз[а-я]*		
Мазохистическое расстройство личности	Мазохистическое расстройство личности	\bмазохистическ[а-я]+ расстройств[а-я]* личности		
Макраканторинхоз	Макраканторинхоз	\bмакраканторинхоз[а-я]*		
Макроглобулинемия Вальденстрёма	Макроглобулинемия Вальденстрёма	\bмакроглобулинем[а-я]+ вальденстр(ё|е)ма		
Макропсия	Макропсия	\bмакропси[а-я]+		
Макроцефалия	Макроцефалия	\bмакроцефали[а-я]+		
Макулярная эдема	Макулярная эдема	\bмакулярн[а-я]+ эдем[а-я]*		
Малая депрессия	Малая депрессия	\bмал[а-я]+ депресси[а-я]*		
Маловодие	Маловодие	\bмаловоди[а-я]*		
Мальабсорбция фруктозы	Мальабсорбция фруктозы	\bмальабсорбц[а-я]+ фруктоз[а-я]*		
Мальформация Арнольда — Киари	Мальформация Арнольда — Киари	\bмальформац[а-я]+ арнольда-киари		
Малярия	Малярия	\bмаляри[а-я]+		
Маннозидоз	Маннозидоз	\bманнозидоз[а-я]*		
Мансонеллёз	Мансонеллёз	\bмансонелл(ё|е)з[а-я]*		
Мантийноклеточная лимфома	Мантийноклеточная лимфома	\bмантийноклеточн[а-я]+ лимфом[а-я]*		
Геморрагическая лихорадка Марбург	Геморрагическая лихорадка Марбург	\bгеморрагическ[а-я]+ лихорадк[а-я]* марбург		
Мастит	Мастит	\bмастит[а-я]*		
Мастоидит	Мастоидит	\bмастоидит[а-я]*		
Мастопатия	Мастопатия	\bмастопати[а-я]*		
Мастоцитоз	Мастоцитоз	\bмастоцитоз[а-я]*		
Матка Кувелера	Матка Кувелера	\bматк[а-я]* кувелера		
Мегаколон	Мегаколон	\bмегаколон[а-я]*		
Мегалокорнеа	Мегалокорнеа	\bмегалокорне[а-я]*		
Медиастинит	Медиастинит	\bмедиастинит[а-я]*		
Медуллобластома	Медуллобластома	\bмедуллобластом[а-я]*		
Межпозвоночная грыжа	Межпозвоночная грыжа	\bмежпозвоночн[а-я]+ грыж[а-я]*		
Межрёберная невралгия	Межрёберная невралгия	\bмежр(ё|е)берн[а-я]+ невралги[а-я]+		
Межъядерная офтальмоплегия	Межъядерная офтальмоплегия	\bмежъядерн[а-я]+ офтальмоплеги[а-я]+		
Меккелев дивертикул	Меккелев дивертикул	\bмеккелев[а-я]* дивертикул[а-я]*		
Меланома	Меланома	\bмеланом[а-я]+		
Меланхолия	Меланхолия	\bмеланхоли[а-я]+		
Мелореостоз	Мелореостоз	\bмелореостоз[а-я]*		
Менингиома	Менингиома	\bменингиом[а-я]+		
Менингит	Менингит	\bменингит[а-я]*		
Менингококковая инфекция	Менингококковая инфекция	\bменингококков[а-я]+ инфекци[а-я]+		
Менингоэнцефалит	Менингоэнцефалит	\bменингоэнцефалит[а-я]*		
Метаболические заболевания	Метаболические заболевания	\bметаболическ[а-я]+ заболеван[а-я]*		
Метаболический ацидоз	Метаболический ацидоз	\bметаболическ[а-я]+ ацидоз[а-я]*		
Метагонимоз	Метагонимоз	\bметагонимоз[а-я]*		
Метаплазия	Метаплазия	\bметаплази[а-я]+		
Метастаз	Метастаз	\bметастаз[а-я]*		
Метастронгилёз	Метастронгилёз	\bметастронгил(ё|е)з[а-я]*		
Метахроматическая лейкодистрофия	Метахроматическая лейкодистрофия	\bметахроматическ[а-я]+ лейкодистрофи[а-я]*		
Метгемоглобинемия	Метгемоглобинемия	\bметгемоглобинеми[а-я]+		
Меторхоз	Меторхоз	\bметорхоз[а-я]*		
Метрит	Метрит	\bметрит[а-я]*		
Миаз полового члена	Миаз полового члена	\bмиаз[а-я]* полового члена		
Миазы	Миазы	\bмиаз[а-я]*		
Миастенический синдром Ламберта — Итона	Миастенический синдром Ламберта — Итона	\bмиастеническ[а-я]+ синдром[а-я]* ламберта-итона		
Миастения	Миастения	\bмиастени[а-я]+		
Мигрень	Мигрень	\bмигрен[а-я]+		
Мидриаз	Мидриаз	\bмидриаз[а-я]*		
Миелит	Миелит	\bмиелит[а-я]*		
Миелодиспластический синдром	Миелодиспластический синдром	\bмиелодиспластическ[а-я]+ синдром[а-я]*		
Миелоидная саркома	Миелоидная саркома	\bмиелоидн[а-я]+ сарком[а-я]*		
Миеломная болезнь	Миеломная болезнь	\bмиеломн[а-я]+ болезн[а-я]+		
Микобактериоз	Микобактериоз	\bмикобактериоз[а-я]*		
Микозы	Микозы	\bмикоз[а-я]*		
Микоплазмы	Микоплазмы	\bмикоплазм[а-я]*		
Микотоксикозы	Микотоксикозы	\bмикотоксикоз[а-я]*		
Микропенис	Микропенис	\bмикропенис[а-я]*		
Микроскопический полиангиит	Микроскопический полиангиит	\bмикроскопическ[а-я]+ полиангиит[а-я]*		
Микротия	Микротия	\bмикроти[а-я]*		
Микроцефалия	Микроцефалия	\bмикроцефали[а-я]+		
Микседема	Микседема	\bмикседем[а-я]*		
Микседематозная кома	Микседематозная кома	\bмикседематозн[а-я]+ ком[а-я]*		
Миксома сердца	Миксома сердца	\bмиксом[а-я]* сердц[а-я]*		
Милиарный туберкулёз	Милиарный туберкулёз	\bмилиарн[а-я]+ туберкул(ё|е)з[а-я]*		
Милиум	Милиум	\bмилиум[а-я]+		
Минная стопа	Минная стопа	\bминн[а-я]+ стоп[а-я]*		
Миодистрофия Дюшенна	Миодистрофия Дюшенна	\bмиодистроф[а-я]+ дюше(нн|н)а		
Миоз	Миоз	\bмиоз[а-я]*		
Миозит	Миозит	\bмиозит[а-я]*		
Миокардит	Миокардит	\bмиокардит[а-я]*		
Миоклоническая дистония	Миоклоническая дистония	\bмиоклоническ[а-я]+ дистони[а-я]*		
Миоклония	Миоклония	\bмиоклони[а-я]+		
Миома матки	Миома матки	\bмиом[а-я]+ матк[а-я]+		
Миопатия	Миопатия	\bмиопати[а-я]+		
Миотония	Миотония	\bмиотони[а-я]+		
Митохондриальные заболевания	Митохондриальные заболевания	\bмитохондриальн[а-я]* заболевани[а-я]+		
Митохондриальный сахарный диабет	Митохондриальный сахарный диабет	\bмитохондриальн[а-я]+ сахарн[а-я]+ диабет[а-я]*		
Мицетома	Мицетома	\bмицетом[а-я]*		
Младенческая колика	Младенческая колика	\bмладенческ[а-я]+ колик[а-я]*		
Многоводие	Многоводие	\bмноговоди[а-я]+		
Множественная сульфатазная недостаточность	Множественная сульфатазная недостаточность	\bмножественн[а-я]+ сульфатазн[а-я]+ недостаточност[а-я]+		
Множественная эндокринная неоплазия	Множественная эндокринная неоплазия	\bмножественн[а-я]+ эндокринн[а-я]+ неоплази[а-я]+( типа IIb)?		
Мозжечковая атаксия	Мозжечковая атаксия	\bмозжечков[а-я]+ атакси[а-я]+		
Молоткообразная деформация пальцев стопы	Молоткообразная деформация пальцев стопы	\bмолоткообразн[а-я]+ деформац[а-я]+ пальцев стопы		
Монгольское пятно	Монгольское пятно	\bмонгольск[а-я]+ пятн[а-я]*		
Мониезиоз	Мониезиоз	\bмониезиоз[а-я]*		
Монилиформоз	Монилиформоз	\bмонилиформоз[а-я]*		
Монопения	Монопения	\bмонопени[а-я]+		
Монорхизм	Монорхизм	\bмонорхизм[а-я]*		
Моноцитоз	Моноцитоз	\bмоноцитоз[а-я]*		
Морская болезнь	Морская болезнь	\bморск[а-я]+ болезн[а-я]+		
Мочекаменная болезнь	Мочекаменная болезнь	\bмочекаменн[а-я]+ болезн[а-я]+		
Мочеполовой миаз	Мочеполовой миаз	\bмочеполов[а-я]+ миаз[а-я]*		
Мраморная болезнь	Мраморная болезнь	\bмраморн[а-я]+ болезн[а-я]+		
Мраморность кожи	Мраморность кожи	\bмраморност[а-я]* кожи		
Муковисцидоз	Муковисцидоз	\bмуковисцидоз[а-я]*		
Муколипидоз	Муколипидоз	\bмуколипидоз[а-я]*		
Мукополисахаридоз	Мукополисахаридоз	\bмукополисахаридоз[а-я]*(  I)?		
Мультисистемная атрофия	Мультисистемная атрофия	\bмультисистемн[а-я]+ атрофи[а-я]+		
Мушки летающие	Мушки летающие	\bмушки летающ[а-я]+		
Мышиный клещевой дерматит	Мышиный клещевой дерматит	\bмышин[а-я]+ клещев[а-я]+ дерматит[а-я]*		
Мэнерик	Мэнерик	\bмэнерик[а-я]*		
Мягкий шанкр	Мягкий шанкр	\bмягк[а-я]* шанкр[а-я]*		
Назальный миаз	Назальный миаз	\bназальн[а-я]+ миаз[а-я]*		
Назофарингеальная карцинома	Назофарингеальная карцинома	\bназофарингеальн[а-я]+ карцином[а-я]*		
Назофарингит	Назофарингит	\bназофарингит[а-я]*		
Найроби дерматит	Найроби дерматит	\bнайроби дерматит[а-я]*		
Нанофиетоз	Нанофиетоз	\bнанофиетоз[а-я]*		
Нарколепсия	Нарколепсия	\bнарколепси[а-я]+		
Наркомания	Наркомания	\bнаркомани[а-я]+		
Наружный отит	Наружный отит	\bнаружн[а-я]+ отит[а-я]*		
Нарушение слуха	Нарушение слуха	\bнарушени[а-я]+( слуха| толерантности к глюкозе| зрения)		
Нарциссизм	Нарциссизм	\bнарциссизм[а-я]*		
Нарциссическое расстройство личности	Нарциссическое расстройство личности	\bнарциссическ[а-я]+ расстройств[а-я]* личности		
Наследственная оптическая нейропатия Лебера	Наследственная оптическая нейропатия Лебера	\bнаследственн[а-я]+ оптическ[а-я]+ нейропати[а-я]+ лебера		
Натуральная оспа	Натуральная оспа	\bнатуральн[а-я]+ осп[а-я]+		
Неалкогольная жировая болезнь печени	Неалкогольная жировая болезнь печени	\bнеалкогольн[а-я]+ жиров[а-я]+ болезн[а-я]+ печени		
Невралгия	Невралгия	\bневралги[а-я]+( тройничного нерва)?		
Неврастения	Неврастения	\bневрастени[а-я]+		
Невринома	Невринома	\bневрином[а-я]*( слухового нерва)?		
Неврит	Неврит	\bневрит[а-я]*		
Невроз	Невроз	\bневроз[а-я]*		
Неврома Мортона	Неврома Мортона	\bневром[а-я]* мортона		
Недержание мочи у женщин	Недержание мочи у женщин	\bнедержани[а-я]+ мочи у женщин		
Недифференцированная шизофрения	Недифференцированная шизофрения	\bнедифференцированн[а-я]+ шизофрени[а-я]+		
Недоедание	Недоедание	\bнедоедани[а-я]+		
Недоношенный ребёнок	Недоношенный ребёнок	\bнедоношенн[а-я]+ реб(е|ё)н[а-я]+		
Недостаточность аортального клапана	Недостаточность аортального клапана	\bнедостаточность[а-я]+( аортального клапана| карбамоилфосфатсинтетазы| кислой фосфатазы| конвергенции| митрального клапана)		
Незидиобластоз	Незидиобластоз	\bнезидиобластоз[а-я]*		
Нейробластома	Нейробластома	\bнейробластом[а-я]*		
Нейрогенный мочевой пузырь	Нейрогенный мочевой пузырь	\bнейрогенн[а-я]+ мочев[а-я]+ пузыр[а-я]+		
Нейрогенный шок	Нейрогенный шок	\bнейрогенн[а-я]+ шок[а-я]*		
Нейролептический паркинсонизм	Нейролептический паркинсонизм	\bнейролептическ[а-я]+ паркинсонизм[а-я]*		
Нейросенсорная тугоухость	Нейросенсорная тугоухость	\bнейросенсорн[а-я]+ тугоухост[а-я]+		
Нейросифилис	Нейросифилис	\bнейросифилис[а-я]*		
Нейроферритинопатия	Нейроферритинопатия	\bнейроферритинопати[а-я]*		
Нейрофиброма	Нейрофиброма	\bнейрофибром[а-я]+		
Нейрофиброматоз	Нейрофиброматоз	\bнейрофиброматоз[а-я]*( (II|2) типа)?		
Некариозные поражения зубов	Некариозные поражения зубов	\bнекариозн[а-я]* поражен[а-я]+ зуб[а-я]+		
Некатороз	Некатороз	\bнекатороз[а-я]*		
Некротический фасциит	Некротический фасциит	\bнекротическ[а-я]+ фасциит[а-я]*		
Некротический энтероколит	Некротический энтероколит	\bнекротическ[а-я]+ энтероколит[а-я]*		
Нематодозы	Нематодозы	\bнематодоз[а-я]*		
Неоваскуляризация роговицы	Неоваскуляризация роговицы	\bнеоваскуляризац[а-я]+ роговицы		
Неонатальный сахарный диабет	Неонатальный сахарный диабет	\bнеонатальн[а-я]+ сахарн[а-я]+ диабет[а-я]*		
Неотложные состояния в урологии	Неотложные состояния в урологии	\bнеотложн[а-я]* состоян[а-я]+ в урологии		
Непереносимость лактозы	Непереносимость лактозы	\bнепереносимост[а-я]+ лактоз[а-я]*		
Нервная булимия	Нервная булимия	\bнервн[а-я]+ булими[а-я]+		
Несахарный диабет	Несахарный диабет	\bнесахарн[а-я]+ диабет[а-я]*		
Несовершенный остеогенез	Несовершенный остеогенез	\bнесовершенн[а-я]+ остеогенез[а-я]*		
Нестабильная стенокардия	Нестабильная стенокардия	\bнестабильн[а-я]+ стенокарди[а-я]+		
Нефрит (заболевание)	Нефрит (заболевание)	\bнефрит[а-я]*		
Нефритический синдром	Нефритический синдром	\bнефритическ[а-я]+ синдром[а-я]*		
Нефробластома	Нефробластома	\bнефробластом[а-я]*		
Нефропатия	Нефропатия	\bнефропати[а-я]*		
Нефросклероз	Нефросклероз	\bнефросклероз[а-я]*		
Неходжкинские лимфомы	Неходжкинские лимфомы	\bнеходжкинск[а-я]+ лимфом[а-я]*		
Никталопия	Никталопия	\bникталопи[а-я]+		
Нимфомания	Нимфомания	\bнимфомани[а-я]+		
Новообразования эндокринной системы	Новообразования эндокринной системы	\bновообразован[а-я]+ эндокринн[а-я]+ системы		
Нома	Нома	\bном[а-я]*		
Носовое кровотечение	Носовое кровотечение	\bносов[а-я]+ кровотечени[а-я]+		
Ночной ужас	Ночной ужас	\bночн[а-я]+ ужас[а-я]*		
Облитерирующий бронхиолит	Облитерирующий бронхиолит	\bоблитерирующ[а-я]+ бронхиолит[а-я]*		
Облитерирующий тромбангиит	Облитерирующий тромбангиит	\bоблитерирующ[а-я]+ тромбангиит[а-я]*		
Обсессивно-компульсивное расстройство	Обсессивно-компульсивное расстройство	\bобсессивно-компульсивн[а-я]* расстройств[а-я]*		
Овальное окно	Овальное окно	\bовальн[а-я]* окн[а-я]*		
Огнестрельная рана	Огнестрельная рана	\bогнестрельн[а-я]+ ран[а-я]*		
Ожирение	Ожирение	\bожирени[а-я]+		
Ожог	Ожог	\bожог[а-я]*		
Ожог яда многоножки	Ожог яда многоножки	\bожог[а-я]* яд[а-я]+ многоножк[а-я]+		
Оксалатная нефропатия	Оксалатная нефропатия	\bоксалатн[а-я]+ нефропати[а-я]+		
Окулярный ишемический синдром	Окулярный ишемический синдром	\bокулярн[а-я]+ ишемическ[а-я]+ синдром[а-я]*		
Олигодендроглиома	Олигодендроглиома	\bолигодендроглиом[а-я]+		
Омская геморрагическая лихорадка	Омская геморрагическая лихорадка	\bомск[а-я]+ геморрагическ[а-я]* лихорадк[а-я]*		
Омфалит	Омфалит	\bомфалит[а-я]*		
Омфалоцеле	Омфалоцеле	\bомфалоцеле		
Онихокриптоз	Онихокриптоз	\bонихокриптоз[а-я]*		
Онихолизис	Онихолизис	\bонихолизис[а-я]*		
Онихомикоз	Онихомикоз	\bонихомикоз[а-я]*		
Онихофагия	Онихофагия	\bонихофаги[а-я]+		
Онхоцеркоз	Онхоцеркоз	\bонхоцеркоз[а-я]*		
Описторхоз	Описторхоз	\bописторхоз[а-я]*		
Опистотонус	Опистотонус	\bопистотонус[а-я]*		
Опоясывающий лишай	Опоясывающий лишай	\bопоясывающ[а-я]+ лиша[а-я]+		
Оппортунистические заболевания	Оппортунистические заболевания	\bоппортунистическ[а-я]+ заболевани[а-я]*		
Опрелость	Опрелость	\bопрелост[а-я]+		
Оптиконевромиелит	Оптиконевромиелит	\bоптиконевромиелит[а-я]*		
Оптическая нейропатия	Оптическая нейропатия	\bоптическ[а-я]+( нейропати[а-я]+( Кьера)?| папиллит[а-я]*)		
Опухоли глаза	Опухоли глаза	\bопухол[а-я]+( глаза| головы и шеи| желудка| печени| слюнных жел(е|ё)з | средостения| языка | (головного )?мозга| клатскина| кости)?		
Опущение и выпадение женских половых органов	Опущение и выпадение женских половых органов	\bопущени[а-я]+ и выпадени[а-я]+ женских половых органов		
Опьянение	Опьянение	\bопьянени[а-я]+		
Оральный миаз	Оральный миаз	\bоральн[а-я]+ миаз[а-я]*		
Орбитальная лимфома	Орбитальная лимфома	\bорбитальн[а-я]+ лимфом[а-я]*		
Орбитальный целлюлит	Орбитальный целлюлит	\bорбитальн[а-я]+ целлюлит[а-я]*		
Орнитодороз	Орнитодороз	\bорнитодороз[а-я]*		
Орнитоз	Орнитоз	\bорнитоз[а-я]*		
Ортостатический коллапс	Ортостатический коллапс	\bортостатическ[а-я]+ коллапс[а-я]*		
Орхит	Орхит	\bорхит[а-я]*		
Оспа обезьян	Оспа обезьян	\bосп[а-я]* обезьян[а-я]*		
Оссифицирующий миозит	Оссифицирующий миозит	\bоссифицирующ[а-я]+ миозит[а-я]*		
Остановка сердца	Остановка сердца	\bостановк[а-я]+ сердц[а-я]+		
Остаточная мембрана зрачка	Остаточная мембрана зрачка	\bостаточн[а-я]+ мембран[а-я]+ зрачк[а-я]+		
Остаточная шизофрения	Остаточная шизофрения	\bостаточн[а-я]+ шизофрени[а-я]+		
Остеоартроз	Остеоартроз	\bостеоартроз[а-я]*		
Остеогенная саркома	Остеогенная саркома	\bостеогенн[а-я]+ сарком[а-я]*		
Остеоид-остеома	Остеоид-остеома	\b(остеоид-)?остеом[а-я]+		
Остеомаляция	Остеомаляция	\bостеомаляци[а-я]+		
Остеомиелит	Остеомиелит	\bостеомиелит[а-я]*		
Остеопойкилия	Остеопойкилия	\bостеопойкили[а-я]+		
Остеопороз	Остеопороз	\bостеопороз[а-я]*		
Остеосклероз	Остеосклероз	\bостеосклероз[а-я]*		
Остеофит	Остеофит	\bостеофит[а-я]*		
Остеохондроз	Остеохондроз	\bостеохондроз[а-я]*		
Остеохондрома	Остеохондрома	\bостеохондром[а-я]*		
Остеохондропатия	Остеохондропатия	\bостеохондропати[а-я]*		
Остеохондропластическая трахеобронхопатия	Остеохондропластическая трахеобронхопатия	\bостеохондропластическ[а-я]+ трахеобронхопатия[а-я]*		
Острая дистония	Острая дистония	\bостр[а-я]+ дистони[а-я]+		
Острая лучевая болезнь	Острая лучевая болезнь	\bостр[а-я]+ лучев[а-я]+ болезн[а-я]*		
Острая реакция на стресс	Острая реакция на стресс	\bостр[а-я]+ реакц[а-я]+ на стресс		
Острая ревматическая лихорадка	Острая ревматическая лихорадка	\bостр[а-я]+ ревматическ[а-я]+ лихорадка[а-я]*		
Остроконечные кондиломы	Остроконечные кондиломы	\bостроконечн[а-я]* кондилом[а-я]+		
Острые и транзиторные психотические расстройства	Острые и транзиторные психотические расстройства	\bостр[а-я]+ и транзиторн[а-я]* психотическ[а-я]+ расстройств[а-я]*		
Острые миелобластные лейкозы	Острые миелобластные лейкозы	\bостр[а-я]+ миелобластн[а-я]* лейкоз[а-я]*		
Острый базофильный лейкоз	Острый базофильный лейкоз	\bостр[а-я]* базофильн[а-я]+ лейкоз[а-я]*		
Острый живот	Острый живот	\bостр[а-я]* живот[а-я]*		
Острый коронарный синдром	Острый коронарный синдром	\bостр[а-я]* коронарн[а-я]+ синдром[а-я]*		
Острый мегакариобластный лейкоз	Острый мегакариобластный лейкоз	\bостр[а-я]* мегакариобластн[а-я]+ лейкоз[а-я]*		
Острый миелобластный лейкоз без созревания	Острый миелобластный лейкоз без созревания	\bостр[а-я]* миелобластн[а-я]+ лейкоз[а-я]*(( без| с) созревани[а-я]*| с минимальной дифференциацией)		
Острый миелоидный дендритноклеточный лейкоз	Острый миелоидный дендритноклеточный лейкоз	\bостр[а-я]* миелоидн[а-я]+ дендритноклеточн[а-я]+ лейкоз[а-я]*		
Острый миелоидный лейкоз	Острый миелоидный лейкоз	\bостр[а-я]* миелоидн[а-я]+ лейкоз[а-я]*		
Острый миеломоноцитарный лейкоз	Острый миеломоноцитарный лейкоз	\bостр[а-я]* миеломоноцитарн[а-я]+ лейкоз[а-я]*		
Острый моноцитарный лейкоз	Острый моноцитарный лейкоз	\bостр[а-я]* моноцитарн[а-я]+ лейкоз[а-я]*		
Острый панкреатит	Острый панкреатит	\bостр[а-я]* панкреатит[а-я]*		
Острый панмиелоз с миелофиброзом	Острый панмиелоз с миелофиброзом	\bостр[а-я]* панмиелоз[а-я]* с миелофиброз[а-я]*		
Острый парапроктит	Острый парапроктит	\bостр[а-я]* парапроктит[а-я]*		
Острый промиелоцитарный лейкоз	Острый промиелоцитарный лейкоз	\bостр[а-я]* промиелоцитарн[а-я]+ лейкоз[а-я]*		
Острый простатит	Острый простатит	\bостр[а-я]* простатит[а-я]*		
Острый рассеянный энцефаломиелит	Острый рассеянный энцефаломиелит	\bостр[а-я]* рассеянн[а-я]+ энцефаломиелит[а-я]*		
Острый респираторный дистресс-синдром	Острый респираторный дистресс-синдром	\bостр[а-я]* респираторн[а-я]+ дистресс-синдром[а-я]*		
Острый тиреоидит	Острый тиреоидит	\bостр[а-я]* тиреоидит[а-я]*		
Острый тонзиллит	Острый тонзиллит	\bостр[а-я]* тонзиллит[а-я]*		
Острый тучноклеточный лейкоз	Острый тучноклеточный лейкоз	\bостр[а-я]* тучноклеточн[а-я]+ лейкоз[а-я]*		
Острый эозинофильный лейкоз	Острый эозинофильный лейкоз	\bостр[а-я]* эозинофильн[а-я]+ лейкоз[а-я]*		
Острый эритроидный лейкоз	Острый эритроидный лейкоз	\bостр[а-я]* эритроидн[а-я]+ лейкоз[а-я]*		
Отёк диска зрительного нерва	Отёк диска зрительного нерва	\bот(е|ё)к[а-я]* диск[а-я]* зрительного нерва		
Отёк лёгких	Отёк лёгких	\bот(е|ё)к[а-я]* л(е|ё)гк[а-я]*		
Отит	Отит	\bотит[а-я]*		
Открытый артериальный проток	Открытый артериальный проток	\bоткрыт[а-я]+ артериальн[а-я]+ проток[а-я]*		
Отморожение	Отморожение	\bотморожени[а-я]+		
Отомиаз	Отомиаз	\bотомиаз[а-я]*		
Отосклероз	Отосклероз	\bотосклероз[а-я]*		
Отравление марганцем	Отравление марганцем	\bотравлени[а-я]+( марганцем| свинцом| угарным газом| фосфорорганическими соединениями| ртутью)		
Отравленная рана	Отравленная рана	\bотравленн[а-я]+ ран[а-я]*		
Отрубевидный лишай	Отрубевидный лишай	\bотрубевидн[а-я]+ лиша[а-я]*		
Отслоение сетчатки	Отслоение сетчатки	\bотслоени[а-я]+ сетчатки		
Офтальмия	Офтальмия	\bофтальми[а-я]+		
Офтальмомиаз	Офтальмомиаз	\bофтальмомиаз[а-я]*		
Офтальмоплегия	Офтальмоплегия	\bофтальмоплеги[а-я]+		
Падение (несчастный случай)	Падение (несчастный случай)	\bпадени[а-я]+		
Панариций	Панариций	\bпанарици[а-я]*		
Пангипопитуитаризм	Пангипопитуитаризм	\bпангипопитуитаризм[а-я]*		
Паническая атака	Паническая атака	\bпаническ[а-я]+ атак[а-я]*		
Паническое расстройство	Паническое расстройство	\bпаническ[а-я]+ расстройств[а-я]*		
Панкреатит	Панкреатит	\bпанкреатит[а-я]*		
Панникулит Вебера — Крисчена	Панникулит Вебера — Крисчена	\bпанникулит[а-я]* вебера-крисчена		
Панофобия	Панофобия	\bпанофоби[а-я]*		
Папилломавирусы человека	Папилломавирусы человека	\bпапилломавирус[а-я]*(человека)?		
Лихорадка паппатачи	Лихорадка паппатачи	\bлихорадк[а-я]* паппатачи		
Папулёз	Папулёз	\bпапул(е|ё)з[а-я]*		
Парагонимоз	Парагонимоз	\bпарагонимоз[а-я]*		
Парагрипп	Парагрипп	\bпарагрипп[а-я]*		
Паразитарные болезни	Паразитарные болезни	\bпаразитарн[а-я]*( болезн| краниопаг)[а-я]*		
Паралич Белла	Паралич Белла	\bпаралич[а-я]* белла		
Паралич блокового нерва	Паралич блокового нерва	\bпаралич[а-я]* блокового нерва		
Паралич глазодвигательного нерва	Паралич глазодвигательного нерва	\bпаралич[а-я]* глазодвигательного нерва		
Паралич Дежерин-Клюмпке	Паралич Дежерин-Клюмпке	\bпаралич[а-я]* дежерин-клюмпке		
Паралич отводящего нерва	Паралич отводящего нерва	\bпаралич[а-я]* отводящего нерва		
Паралич сопряжённого взгляда	Паралич сопряжённого взгляда	\bпаралич[а-я]* сопряж(е|ё)нного взгляда		
Паранефрит	Паранефрит	\bпаранефрит[а-я]*		
Параноидная шизофрения	Параноидная шизофрения	\bпараноидн[а-я]+ шизофрени[а-я]+		
Параноидное расстройство личности	Параноидное расстройство личности	\bпараноидно[а-я]* расстройств[а-я]* личности		
Паранойя	Паранойя	\bпараной[а-я]+		
Паранойяльная шизофрения	Паранойяльная шизофрения	\bпаранойяльн[а-я]+ шизофрени[а-я]+		
Парапроктит	Парапроктит	\bпарапроктит[а-я]*		
Парапротеинемия	Парапротеинемия	\bпарапротеинеми[а-я]+		
Парасомния	Парасомния	\bпарасомни[а-я]+		
Паратифы	Паратифы	\bпаратиф[а-я]*		
Паратонзиллярный абсцесс	Паратонзиллярный абсцесс	\bпаратонзиллярн[а-я]+ абсцесс[а-я]*		
Парафазия	Парафазия	\bпарафази[а-я]+		
Парафимоз	Парафимоз	\bпарафимоз[а-я]*		
Парез	Парез	\bпарез[а-я]*		
Паркинсонизм	Паркинсонизм	\bпаркинсонизм[а-я]*		
Пародонтит	Пародонтит	\bпародонтит[а-я]*		
Пародонтоз	Пародонтоз	\bпародонтоз[а-я]*		
Пароксизм	Пароксизм	\bпароксизм[а-я]*		
Паронихия	Паронихия	\bпаронихи[а-я]*		
Паростальная саркома	Паростальная саркома	\bпаростальн[а-я]+ сарком[а-я]*		
Паротит	Паротит	\bпаротит[а-я]*		
Пассивно-агрессивное расстройство личности	Пассивно-агрессивное расстройство личности	\bпассивно-агрессивн[а-я]* расстройств[а-я]* личности		
Пастереллёз	Пастереллёз	\bпастерелл(е|ё)з[а-я]*		
Патологическая стираемость зубов	Патологическая стираемость зубов	\bпатологическ[а-я]+( стираемость[а-я]* зубов| перелом[а-я]*| прикус[а-я]*| опьянени[а-я]+)		
Паховая гранулёма	Паховая гранулёма	\bпахов[а-я]+ гранул(е|ё)м[а-я]*		
Паховая грыжа	Паховая грыжа	\bпахов[а-я]+ грыж[а-я]*		
Педикулёз	Педикулёз	\bпедикул(е|ё)з[а-я]*		
Пеллагра	Пеллагра	\bпеллагр[а-я]+		
Пеллюцидная краевая дегенерация	Пеллюцидная краевая дегенерация	\bпеллюцидн[а-я]+ краев[а-я]+ дегенераци[а-я]+		
Пемфигус	Пемфигус	\bпемфигус[а-я]*		
Пентозурия	Пентозурия	\bпентозури[а-я]+		
Первазивное расстройство развития без дополнительных уточнений	Первазивное расстройство развития без дополнительных уточнений	\bпервазивн[а-я]* расстройств[а-я]* развит[а-я]+ без дополнительных уточнений		
Первичный амёбный менингоэнцефалит	Первичный амёбный менингоэнцефалит	\bпервичн[а-я]+ ам(е|ё)бн[а-я]+ менингоэнцефалит[а-я]*		
Первичный гиперальдостеронизм	Первичный гиперальдостеронизм	\bпервичн[а-я]+ гиперальдостеронизм[а-я]*		
Передозировка	Передозировка	\bпередозировк[а-я]+		
Перекрут яичка	Перекрут яичка	\bперекрут[а-я]* яичк[а-я]+		
Перелом грудины	Перелом грудины	\bперелом[а-я]*( грудины| джефферсона| диафиза бедренной кости| зубовидного отростка| ключицы|( кост[а-я]+| основания)?( носа| черепа)| лопатки| палача| плюсневых костей| позвоночника| полового члена| шейки бедра| р(ё|е)б[а-я]+)		
Переношенная беременность	Переношенная беременность	\bпереношенн[а-я]+ беременност[а-я]*		
Перивентрикулярная лейкомаляция	Перивентрикулярная лейкомаляция	\bперивентрикулярн[а-я]+ лейкомляци[а-я]+		
Перикардит	Перикардит	\bперикардит[а-я]*		
Перикоронит	Перикоронит	\bперикоронит[а-я]*		
Периодическая болезнь	Периодическая болезнь	\bпериодическ[а-я]+ болезн[а-я]*		
Периорбитальной целлюлит	Периорбитальной целлюлит	\bпериорбитальн[а-я]+ целлюлит[а-я]*		
Перитонит	Перитонит	\bперитонит[а-я]*		
Перламутровые папулы	Перламутровые папулы	\bперламутров[а-я]* папул[а-я]*		
Персистенция фетального гемоглобина	Персистенция фетального гемоглобина	\bперсистенц[а-я]+ фетального гемоглобина		
Перфорация матки	Перфорация матки	\bперфорац[а-я]+ матки		
Печёночная кома	Печёночная кома	\bпеч(е|ё)ночн[а-я]+ ком[а-я]*		
Пиблокто	Пиблокто	\bпиблокто		
Пигментный ретинит	Пигментный ретинит	\bпигментн[а-я]+ ретинит[а-я]*		
Пиелонефрит	Пиелонефрит	\bпиелонефрит[а-я]*		
Пикнодизостоз	Пикнодизостоз	\bпикнодизостоз[а-я]*		
Пингвукула	Пингвукула	\bпингвукул[а-я]*		
Пинеалома	Пинеалома	\bпинеалом[а-я]*		
Пиодермия	Пиодермия	\bпиодерми[а-я]+		
Пионефроз	Пионефроз	\bпионефроз[а-я]*		
Пиролагния	Пиролагния	\bпиролагни[а-я]+		
Пироплазмоз крупного рогатого скота	Пироплазмоз крупного рогатого скота	\bпироплазмоз[а-я]* крупного рогатого скота		
Пищевая аллергия	Пищевая аллергия	\bпищев[а-я]+ аллерги[а-я]+		
Пищевод Барретта	Пищевод Барретта	\bпищевод[а-я]* барретта		
Плагиоцефалия	Плагиоцефалия	\bплагиоцефали[а-я]+		
Пламенеющий невус	Пламенеющий невус	\bпламенеющ[а-я]+ невус[а-я]*		
Плантарный фасциит	Плантарный фасциит	\bплантарн[а-я]+ фасциит[а-я]*		
Платибазия	Платибазия	\bплатибази[а-я]+		
Платяной педикулёз	Платяной педикулёз	\bплатян[а-я]+ педикул(е|ё)з[а-я]*		
Плеврит	Плеврит	\bплеврит[а-я]*		
Плоская роговица, тип 2	Плоская роговица, тип 2	\bплоск[а-я]+ роговиц[а-я]*		
Плоскостопие	Плоскостопие	\bплоскостопи[а-я]+		
Пневмококковая инфекция	Пневмококковая инфекция	\bпневмококков[а-я]+ инфекци[а-я]+		
Пневмокониоз	Пневмокониоз	\bпневмокониоз[а-я]*		
Пневмонит	Пневмонит	\bпневмонит[а-я]*		
Пневмония	Пневмония	\bпневмони[а-я]+		
Пневмоцистная пневмония	Пневмоцистная пневмония	\bпневмоцистн[а-я]+ пневмони[а-я]+		
Поверхностный точечный кератит	Поверхностный точечный кератит	\bповерхностн[а-я]+ точечн[а-я]+ кератит[а-я]*		
Повреждение мозга	Повреждение мозга	\bповреждени[а-я]+( мозга| почек и мочевых путей)		
Пограничное расстройство личности	Пограничное расстройство личности	\bпогранично[а-я]* расстройств[а-я]* личности		
Подагра	Подагра	\bподагр[а-я]*		
Подвывих головки лучевой кости	Подвывих головки лучевой кости	\bподвывих[а-я]* головки лучевой кости		
Подкожная эмфизема	Подкожная эмфизема	\bподкожн[а-я]+ эмфизем[а-я]*		
Подкорковая атеросклеротическая энцефалопатия	Подкорковая атеросклеротическая энцефалопатия	\bподкорков[а-я]+ атеросклеротическ[а-я]+ энцефалопати[а-я]+		
Подострый лимфоцитарный тиреоидит	Подострый лимфоцитарный тиреоидит	\bподостр[а-я]* лимфоцитарн[а-я]+ тиреоидит[а-я]*		
Подострый тиреоидит	Подострый тиреоидит	\bподостр[а-я]* тиреоидит[а-я]*		
Подошвенные бородавки	Подошвенные бородавки	\bподошвенн[а-я]* бородавк[а-я]*		
Поздняя дискинезия	Поздняя дискинезия	\bпоздн[а-я]*( дискинези| дистони)[а-я]+		
Покраснение радужной оболочки	Покраснение радужной оболочки	\bпокраснени[а-я]+ радужной оболочки		
Полиартрит	Полиартрит	\bполиартрит[а-я]*		
Полидактилия	Полидактилия	\bполидактили[а-я]+		
Поликистоз почек	Поликистоз почек	\bполикистоз[а-я]*		
Полиневрит	Полиневрит	\bполиневрит[а-я]*		
Полинейропатия	Полинейропатия	\bполинейропат[а-я]+( критических состояний)?		
Полиодонтия	Полиодонтия	\bполиодонти[а-я]*		
Полиомиелит	Полиомиелит	\bполиомиелит[а-я]*		
Полиорганная недостаточность	Полиорганная недостаточность	\bполиорганн[а-я]+ недостаточност[а-я]+		
Полип	Полип	\bполип[а-я]*( желудка | (желчного|мочевого) пузыря| носа| (тела|шейки) матки| (толстой )?кишки| у(ха|шей))?		
Полителия	Полителия	\bполители[а-я]+		
Поллиноз	Поллиноз	\bполлиноз[а-я]*		
Понтиакская лихорадка	Понтиакская лихорадка	\bпонтиакск[а-я]+ лихорадк[а-я]+		
Поражения черепных нервов	Поражения черепных нервов	\bпоражен[а-я]+ черепн[а-я]+ нерв[а-я]*		
Пороки развития	Пороки развития	\bпорок[а-я]* развити[а-я]*		
Пороцефалёз	Пороцефалёз	\bпороцефал(е|ё)з[а-я]*		
Портальная гипертензия	Портальная гипертензия	\bпортальн[а-я]+ гипертензи[а-я]+		
Порфирия	Порфирия	\bпорфири[а-я]+		
Послеродовой психоз	Послеродовой психоз	\bпослеродов[а-я]+ психоз[а-я]*		
Послеродовой тиреоидит	Послеродовой тиреоидит	\bпослеродов[а-я]+ тиреоидит[а-я]*		
Постинфарктный синдром	Постинфарктный синдром	\bпостинфарктн[а-я]+ синдром[а-я]*		
Постнатальная депрессия	Постнатальная депрессия	\bпостнатальн[а-я]+ депресси[а-я]*		
Посттравматическое стрессовое расстройство	Посттравматическое стрессовое расстройство	\bпосттравматическ[а-я]+ стрессов[а-я]+ расстройств[а-я]*		
Постшизофреническая депрессия	Постшизофреническая депрессия	\bпостшизофреническ[а-я]+ депресси[а-я]+		
Потница	Потница	\bпотниц[а-я]*		
Почесуха	Почесуха	\bпочесух[а-я]*		
Почечная гликозурия	Почечная гликозурия	\bпочечн[а-я]+ гликозури[а-я]+		
Почечнокаменная болезнь	Почечнокаменная болезнь	\bпочечнокаменн[а-я]+ болезн[а-я]*		
Почечный тубулярный ацидоз	Почечный тубулярный ацидоз	\bпочечн[а-я]+ тубулярн[а-я]+ ацидоз[а-я]*		
ППома	ППома	\bппом[а-я]*		
Предиабет	Предиабет	\bпредиабет[а-я]*		
Преждевременная эякуляция	Преждевременная эякуляция	\bпреждевременн[а-я]+ эякуляци[а-я]+		
Преходящее нарушение мозгового кровообращения	Преходящее нарушение мозгового кровообращения	\bпреходящ[а-я]+ нарушени[а-я]+ мозгового кровообращения		
Приапизм	Приапизм	\bприапизм[а-я]*		
Приобретённые пороки сердца	Приобретённые пороки сердца	\bприобрет(е|ё)нн[а-я]* порок[а-я]* сердца		
Прионы	Прионы	\bприон[а-я]*		
Пробки в миндалинах	Пробки в миндалинах	\bпробк[а-я]+ в миндалин[а-я]+		
Прогерия	Прогерия	\bпрогери[а-я]+		
Прогнатизм	Прогнатизм	\bпрогнатизм[а-я]*		
Прогрессивный паралич	Прогрессивный паралич	\bпрогрессивн[а-я]+ паралич[а-я]*		
Прогрессирующая внешняя офтальмоплегия	Прогрессирующая внешняя офтальмоплегия	\bпрогрессирующ[а-я]+( внешн[а-я]+ офтальмоплеги[а-я]+| мультифокальн[а-я]+ лейкоэнцефалопати[а-я]+| супрануклеарн[а-я]+ парез[а-я]* взор[а-я]*)		
Прозопагнозия	Прозопагнозия	\bпрозопагнози[а-я]+		
Проктит	Проктит	\bпроктит[а-я]*		
Пролапс митрального клапана	Пролапс митрального клапана	\bпролапс[а-я]* митрального клапана		
Пролежень	Пролежень	\bпролежен[а-я]*		
Проникающие ранения головы	Проникающие ранения головы	\bпроникающ[а-я]+ ранен[а-я]+ головы		
Простатит	Простатит	\bпростатит[а-я]*		
Простой герпес	Простой герпес	\bпрост[а-я]+ герпес[а-я]*		
Простой тип шизофрении	Простой тип шизофрении	\bпрост[а-я]+ тип[а-я]* шизофрении		
Протозойные инфекции	Протозойные инфекции	\bпротозойн[а-я]* инфекци[а-я]+		
Псевдамфистомоз	Псевдамфистомоз	\bпсевдамфистомоз[а-я]*		
Псевдоартроз	Псевдоартроз	\bпсевдоартроз[а-я]*		
Псевдогермафродитизм	Псевдогермафродитизм	\bпсевдогермафродитизм[а-я]*		
Псевдогиперальдостеронизм	Псевдогиперальдостеронизм	\bпсевдогиперальдостеронизм[а-я]*		
Псевдогипоальдостеронизм	Псевдогипоальдостеронизм	\bпсевдогипоальдостеронизм[а-я]*		
Псевдомембранозный энтероколит	Псевдомембранозный энтероколит	\bпсевдомембранозн[а-я]+ энтероколит[а-я]*		
Псевдомиксома брюшной полости	Псевдомиксома брюшной полости	\bпсевдомиксом[а-я]* брюшной полости		
Псевдоневротическая шизофрения	Псевдоневротическая шизофрения	\bпсевдоневротическ[а-я]+ шизофрени[а-я]+		
Псевдополидистрофия Гурлер	Псевдополидистрофия Гурлер	\bпсевдополидистроф[а-я]+ гурлер[а-я]*		
Псевдопсихопатическая шизофрения	Псевдопсихопатическая шизофрения	\bпсевдопсихопатическ[а-я]+ шизофрени[а-я]+		
Псевдотуберкулёз	Псевдотуберкулёз	\bпсевдотуберкул(е|ё)з[а-я]*		
Психалгия	Психалгия	\bпсихалги[а-я]+		
Психастения	Психастения	\bпсихастени[а-я]+		
Психическое расстройство	Психическое расстройство	\bпсихическ[а-я]+ расстройств[а-я]+		
Психогенное переедание	Психогенное переедание	\bпсихогенно[а-я]* переедани[а-я]+		
Психоз	Психоз	\bпсихоз[а-я]*		
Псориаз	Псориаз	\bпсориаз[а-я]*		
Псориатический артрит	Псориатический артрит	\bпсориатическ[а-я]+ артрит[а-я]*		
Птеригий	Птеригий	\bптериги[а-я]+		
Птичий грипп	Птичий грипп	\bптич[а-я]+ грипп[а-я]*		
Птоз верхнего века	Птоз верхнего века	\bптоз[а-я]* верхн[а-я]+ век[а-я]*		
Пузырно-мочеточниковый рефлюкс	Пузырно-мочеточниковый рефлюкс	\bпузырно-мочеточников[а-я]+ рефлюкс[а-я]*		
Пузырный занос	Пузырный занос	\bпузырн[а-я]+ занос[а-я]*		
Пуликоз	Пуликоз	\bпуликоз[а-я]*		
Пуллороз	Пуллороз	\bпуллороз[а-я]*		
Пульпит	Пульпит	\bпульпит[а-я]*		
Пустула	Пустула	\bпустул[а-я]*		
Пчелиный яд	Пчелиный яд	\bпчелин[а-я]+ яд[а-я]*		
Пятнистая дистрофия роговицы	Пятнистая дистрофия роговицы	\bпятнист[а-я]+ дистрофи[а-я]+ роговиц[а-я]*		
Пятнистая лихорадка Скалистых гор	Пятнистая лихорадка Скалистых гор	\bпятнист[а-я]+ лихорадк[а-я]* скалистых гор		
Рабдитозы	Рабдитозы	\bрабдитоз[а-я]*		
Рабдомиолиз	Рабдомиолиз	\bрабдомиолиз[а-я]*		
Рабдомиома	Рабдомиома	\bрабдомиом[а-я]*		
Рабдомиосаркома	Рабдомиосаркома	\bрабдомиосарком[а-я]*		
Радиационное поражение	Радиационное поражение	\bрадиационно[а-я]* поражени[а-я]+		
Радикулит	Радикулит	\bрадикулит[а-я]*		
Раздражающий контакный дерматит	Раздражающий контакный дерматит	\bраздражающ[а-я]+ контакн[а-я]+ дерматит[а-я]*		
Размозжённая рана	Размозжённая рана	\bразмозж(е|ё)нн[а-я]+ ран[а-я]*		
Разрыв матки	Разрыв матки	\bразрыв[а-я]*( матки| мозжечкового намета| сердца)		
Рак верхушки лёгкого с синдромом Панкоста	Рак верхушки лёгкого с синдромом Панкоста	\bрак[а-я]* верхушки л(е|ё)гк[а-я]+ с синдромом панкоста		
Рак влагалища	Рак влагалища	\bрак[а-я]* влагалища		
Рак гортани	Рак гортани	\bрак[а-я]* гортани		
Рак губы	Рак губы	\bрак[а-я]* губы		
Рак желудка	Рак желудка	\bрак[а-я]* желудка		
Рак кожи	Рак кожи	\bрак[а-я]* кожи		
Рак лёгкого	Рак лёгкого	\bрак[а-я]* л(е|ё)гк[а-я]+		
Рак молочной железы	Рак молочной железы	\bрак[а-я]* молочн[а-я]+ желез[а-я]*		
Рак мочевого пузыря	Рак мочевого пузыря	\bрак[а-я]* мочевого пузыря		
Рак поджелудочной железы	Рак поджелудочной железы	\bрак[а-я]* поджелудочн[а-я]+ железы		
Рак полового члена	Рак полового члена	\bрак[а-я]* полового члена		
Рак почки	Рак почки	\bрак[а-я]* почки		
Рак предстательной железы	Рак предстательной железы	\bрак[а-я]* предстательн[а-я]+ железы		
Рак шейки матки	Рак шейки матки	\bрак[а-я]* шейки матки		
Рак щитовидной железы	Рак щитовидной железы	\bрак[а-я]* щитовидн[а-я]+ железы		
Рак яичника	Рак яичника	\bрак[а-я]* яичника		
Рак in situ	Рак in situ	\bрак[а-я]* in situ		
Рассекающий остеохондрит	Рассекающий остеохондрит	\bрассекающ[а-я]+ остеохондрит[а-я]*		
Рассеянный склероз	Рассеянный склероз	\bрассеянн[а-я]+ склероз[а-я]*		
Расслоение аорты	Расслоение аорты	\bрасслоени[а-я]+ аорт[а-я]*		
Расслоение коронарной артерии	Расслоение коронарной артерии	\bрасслоени[а-я]+ коронарн[а-я]+ артери[а-я]*		
Расстройства приёма пищи	Расстройства приёма пищи	\bрасстройства[а-я]*( при(е|ё)ма пищи| добавочного нерва| личности)		
Расстройство добавочного нерва	Расстройство добавочного нерва	\bрасстройств[а-я]* добавочного нерва		
Расстройство личности	Расстройство личности	\bрасстройств[а-я]* личности		
Расторможенное расстройство привязанности	Расторможенное расстройство привязанности	\bрасторможенно[а-я]* расстройств[а-я]* привязанности		
Растяжение связок	Растяжение связок	\bрастяжени[а-я]+ связ[а-я]+		
Расходящееся косоглазие	Расходящееся косоглазие	\bрасходяще[а-я]+ косоглази[а-я]+		
Расщепление нёба	Расщепление нёба	\bрасщеплени[а-я]+ н(е|ё)ба		
Расщепление позвоночника	Расщепление позвоночника	\bрасщеплени[а-я]+ позвоночника		
Рахисхизис	Рахисхизис	\bрахисхизис[а-я]*		
Рахит	Рахит	\bрахит[а-я]*		
Рвота беременных	Рвота беременных	\b(рвот[а-я]* беременн[а-я]*|токсикоз[а-я]*)		
Реактивное расстройство привязанности	Реактивное расстройство привязанности	\bреактивно[а-я]* расстройств[а-я]* привязанности		
Реактивный артрит	Реактивный артрит	\bреактивн[а-я]+ артрит[а-я]*		
Реакция отторжения трансплантата	Реакция отторжения трансплантата	\bреакц[а-я]+ отторжен[а-я]+ трансплантат[а-я]*		
Ревматоидный артрит	Ревматоидный артрит	\bревматоидн[а-я]+ артрит[а-я]*		
Ревмокардит	Ревмокардит	\bревмокардит[а-я]*		
Синдром Рейтера	Синдром Рейтера	\bсиндром рейтера		
Рекурвация колена	Рекурвация колена	\bрекурвац[а-я]+ колен[а-я]*		
Респираторно-синцитиальный вирус человека	Респираторно-синцитиальный вирус человека	\bреспираторно-синцитиальн[а-я]+ вирус[а-я]*		
Респираторный дистресс-синдром новорождённых	Респираторный дистресс-синдром новорождённых	\bреспираторн[а-я]+ дистресс-синдром[а-я]* новорожд(е|ё)нн[а-я]+		
Рестриктивная кардиомиопатия	Рестриктивная кардиомиопатия	\bрестриктивн[а-я]+ кардиомиопати[а-я]*		
Ретикулярная асфиксия	Ретикулярная асфиксия	\bретикулярн[а-я]+ асфикси[а-я]*		
Ретинит	Ретинит	\bретинит[а-я]*		
Ретинобластома	Ретинобластома	\bретинобластом[а-я]*		
Ретинопатия	Ретинопатия	\bретинопати[а-я]*		
Ретинопатия недоношенных	Ретинопатия недоношенных	\bретинопат[а-я]+ недоношенн[а-я]+		
Ретинопатия Purtscher	Ретинопатия Purtscher	\bретинопат[а-я]+ Purtscher		
Ретиношизис	Ретиношизис	\bретиношизис[а-я]*		
Ретроверсия матки	Ретроверсия матки	\bретроверс[а-я]+ матк[а-я]*		
Решётчатая дистрофия роговицы, тип I	Решётчатая дистрофия роговицы, тип I	\bреш(е|ё)тчат[а-я]+ дистроф[а-я]+ роговиц[а-я]*		
Ринит	Ринит	\bринит[а-я]*		
Ринофима	Ринофима	\bринофим[а-я]*		
Ринэстроз	Ринэстроз	\bринэстроз[а-я]*		
Лихорадка Рифт-Валли	Лихорадка Рифт-Валли	\bлихорадк[а-я]+ рифт-валли		
Робовирусы	Робовирусы	\bробовирус[а-я]*		
Роговичная дуга	Роговичная дуга	\bроговичн[а-я]+ дуг[а-я]*		
Родильная горячка	Родильная горячка	\bродильн[а-я]+ горячк[а-я]+		
Родинка	Родинка	\b(родинк[а-я]+|родинок)		
Родовая травма	Родовая травма	\bродов[а-я]+ травм[а-я]*		
Рожа	Рожа	\bрож[а-я]+		
Розацеа	Розацеа	\bрозаце[а-я]*		
Розовый лишай	Розовый лишай	\bрозов[а-я]+ лиша[а-я]*		
Ротавирусная инфекция	Ротавирусная инфекция	\bротавирусн[а-я]+ инфекци[а-я]+		
Рубленая рана	Рубленая рана	\bрублен[а-я]+ ран[а-я]*		
Садистическое расстройство личности	Садистическое расстройство личности	\bсадистическ[а-я]+ расстройств[а-я]* личности		
Садомазохизм	Садомазохизм	\bсадомазохизм[а-я]*		
Сакрококцигеальная тератома	Сакрококцигеальная тератома	\bсакрококцигеальн[а-я]+ тератом[а-я]*		
Сальмонеллёзы	Сальмонеллёзы	\bсальмонелл(е|ё)з[а-я]*		
Сальпингит	Сальпингит	\bсальпингит[а-я]*		
Санация полости рта	Санация полости рта	\bсанац[а-я]+ полост[а-я]+ рта		
Сап	Сап	\bсап[а-я]*		
Саркоидоз	Саркоидоз	\bсаркоидоз[а-я]*		
Саркома	Саркома	\bсарком[а-я]*		
Саркома Капоши	Саркома Капоши	\bсарком[а-я]* капоши		
Саркома Юинга	Саркома Юинга	\bсарком[а-я]* юинга		
Саркопсиллёз	Саркопсиллёз	\bсаркопсилл(е|ё)з[а-я]*		
Сатириазис	Сатириазис	\bсатириазис[а-я]*		
Сахарный диабет	Сахарный диабет	\bсахарн[а-я]+ диабет[а-я]*( (1|2)-го тип[а-я]*| беременн[а-я]*)?		
Сахарный диабет 1-го типа	Сахарный диабет 1-го типа	\bсахарн[а-я]+ диабет 1-го типа		
Сахарный диабет 2-го типа	Сахарный диабет 2-го типа	\bсахарн[а-я]+ диабет 2-го типа		
Сахарный диабет беременных	Сахарный диабет беременных	\bсахарн[а-я]+ диабет беременных		
Светобоязнь	Светобоязнь	\bсветобоязн[а-я]+		
Световой чихательный рефлекс	Световой чихательный рефлекс	\bсветов[а-я]+ чихательн[а-я]+ рефлекс[а-я]*		
Свиной грипп	Свиной грипп	\bсвин[а-я]+ грипп[а-я]*		
Сдавление головного мозга	Сдавление головного мозга	\bсдавлени[а-я]+ головного мозга		
Себорейный дерматит	Себорейный дерматит	\bсеборейн[а-я]+ дерматит[а-я]*		
Себорея	Себорея	\bсебор[а-я]+		
Сексуальное отвращение	Сексуальное отвращение	\bсексуальн[а-я]+( отвращени| дисфункци| фетишизм)[а-я]*		
Сенестопатическая шизофрения	Сенестопатическая шизофрения	\bсенестопатическ[а-я]+ шизофрени[а-я]+		
Сепарационная тревога	Сепарационная тревога	\bсепарационн[а-я]+ тревог[а-я]+		
Сепсис	Сепсис	\bсепсис[а-я]*		
Сердечная недостаточность	Сердечная недостаточность	\bсердечн[а-я]+ недостаточност[а-я]+		
Серповидноклеточная анемия	Серповидноклеточная анемия	\bсерповидноклеточн[а-я]+ анеми[а-я]+		
Сетариоз	Сетариоз	\bсетариоз[а-я]*		
Сиалидоз	Сиалидоз	\bсиалидоз[а-я]*		
Сиалолипидоз	Сиалолипидоз	\bсиалолипидоз[а-я]*		
Сиамские близнецы	Сиамские близнецы	\bсиамск[а-я]+ близнец[а-я]*		
Сибирская язва	Сибирская язва	\bсибирск[а-я]+ язв[а-я]*		
Сигматизм	Сигматизм	\bсигматизм[а-я]*		
Сигуатера	Сигуатера	\bсигуатер[а-я]+		
Сикоз	Сикоз	\bсикоз[а-я]*		
Силикатоз	Силикатоз	\bсиликатоз[а-я]*		
Силикоз	Силикоз	\bсиликоз[а-я]*		
Сингамоз	Сингамоз	\bсингамоз[а-я]*		
Синдактилия	Синдактилия	\bсиндактили[а-я]+		
Синдром Ади	Синдром Ади	\bсиндром[а-я]*( Ади| альфа-талассемии и умственной отсталости| амниотических перетяжек| Ангельмана| Аспергера| Барде-Бидля| Б(е|ё)рта-Хога-Дьюба| Блума| Брауна| Бругада| Бушке-Оллендорфа| Бь(е|ё)рнстада| Вольфа-Паркинсона-Уайта| Гешвинда| Гийена-Барре| гипоплазии левых отделов сердца|  Дауна| деперсонализации-дереализации| длительного сдавления| Дуэйна| Жильбера| Кавасаки| кажущегося избытка минералокортикоидов| Каллмана| Картагенера| Кернса-Сейра| Клейне-Левина| Коккейна| Конна| Корсакова| кошачьего крика| Лайелла| Ландау-Клеффнера| Ларона| Лауна-Ганонга-Левайна| Лея| Лиддла| лиссэнцефалии| Миллера-Дикера| лобной доли| Люси-Дрисколл| Маллори-Вейсса| М(е|ё)биуса| Меккеля-Грубера| Мелькерсона-Розенталя| Мендельсона| Морганьи-Адамса-Стокса| Морганьи-Стюарта-Мореля| Мориака| Моркио| мышечной скованности| Нельсона| Парино| Пархона| Педжета-Шр(е|ё)ттера| Пехкранца-Бабинского-Фрелиха| повреждения Неймегена| Прадера-Вилли| приобрет(е|ё)нного иммунного дефицита| Протея| Пфайффера| раздраж(е|ё)нного кишечника| Рефсума| Робинова| Рубинштейна-Тейби| Сандхоффа| Свайера| Сиппла| системной воспалительной реакции организма| Слая| слепой кишечной петли| Сотоса| Стиклера| Сусака| Терсона| Тричера Коллинза| Туретта| Ушера| фасеточных суставов| фокомелии| Фостер Кеннеди| Холта-Орама| хронической передозировки инсулина| Шарля Бонне| Шарпа| Шегрена| Шерешевского-Т(е|ё)рнера| Шмидта|  Эдвардса| Элерса-Данлоса| GRACILE| PFAPA)		
Синестезия	Синестезия	\bсинестези[а-я]+		
Синехии половых губ	Синехии половых губ	\bсинехи[а-я]*(полов[а-я]* губ[а-я]*| радужн[а-я]+ оболоч[а-я]+)		
Синовиальная саркома	Синовиальная саркома	\bсиновиальн[а-я]+ сарком[а-я]*		
Синовиома	Синовиома	\bсиновиом[а-я]*		
Синовит	Синовит	\bсиновит[а-я]*		
Синтаксическая афазия	Синтаксическая афазия	\bсинтаксическ[а-я]+ афази[а-я]+		
Синусит	Синусит	\bсинусит[а-я]*		
Синусовая тахикардия	Синусовая тахикардия	\bсинусов[а-я]+ тахикарди[а-я]*		
Сиреномелия	Сиреномелия	\bсиреномели[а-я]+		
Сирингомиелия	Сирингомиелия	\bсирингомиели[а-я]+		
Системная красная волчанка	Системная красная волчанка	\bсистемн[а-я]+ красн[а-я]+ волчанк[а-я]*		
Системная склеродермия	Системная склеродермия	\bсистемн[а-я]+ склеродерми[а-я]+		
Сифилис	Сифилис	\bсифилис[а-я]*		
Скальпированная рана	Скальпированная рана	\bскальпированн[а-я]+ ран[а-я]*		
Скарабиаз	Скарабиаз	\bскарабиаз[а-я]*		
Скарлатина	Скарлатина	\bскарлатин[а-я]*		
Складчатый язык	Складчатый язык	\bскладчат[а-я]* язык[а-я]*		
Склерит	Склерит	\bсклерит[а-я]*		
Склеродактилия	Склеродактилия	\bсклеродактили[а-я]+		
Сколецифобия	Сколецифобия	\bсколецифоби[а-я]*		
Сколиоз	Сколиоз	\bсколиоз[а-я]*		
Скорпионизм	Скорпионизм	\bскорпионизм[а-я]*		
Скотома	Скотома	\bскотом[а-я]*		
Слепота	Слепота	\bслепот[а-я]*		
Собачий грипп	Собачий грипп	\bсобач[а-я]* грипп[а-я]*		
Содоку	Содоку	\bсодоку		
Солнечный удар	Солнечный удар	\bсолнечн[а-я]+ удар[а-я]*		
Соматизированное расстройство	Соматизированное расстройство	\bсоматизированн[а-я]* расстройств[а-я]*		
Соматостатинома	Соматостатинома	\bсоматостатином[а-я]*		
Сомнамбулизм	Сомнамбулизм	\bсомнамбулизм[а-я]*		
Сонный паралич	Сонный паралич	\bсонн[а-я]+ паралич[а-я]*		
Сотрясение	Сотрясение	\bсотрясени[а-я]+		
Сотрясение мозга	Сотрясение мозга	\bсотрясени[а-я]+ моз[а-я]*		
Социофобия	Социофобия	\bсоциофоби[а-я]+		
Спарганоз	Спарганоз	\bспарганоз[а-я]*		
Спастическая кривошея	Спастическая кривошея	\bспастическ[а-я]+ кривоше[а-я]+		
Спастичность	Спастичность	\bспастичност[а-я]+		
Сперматорея	Сперматорея	\bсперматор[а-я]+		
Специфические фобии	Специфические фобии	\bспецифическ[а-я]+ фоби[а-я]+		
Спинальная мышечная атрофия	Спинальная мышечная атрофия	\bспинальн[а-я]+ мышечн[а-я]+ атрофи[а-я]+		
Спинальный инсульт	Спинальный инсульт	\bспинальн[а-я]+ инсульт[а-я]*		
Спинная сухотка	Спинная сухотка	\bспинн[а-я]+ сухотк[а-я]+		
Спиноцеребеллярная атаксия	Спиноцеребеллярная атаксия	\bспиноцеребеллярн[а-я]+ атакси[а-я]+		
Спленомегалия	Спленомегалия	\bспленомегали[а-я]+		
Спондилёз	Спондилёз	\bспондил(е|ё)з[а-я]*		
Спондилолиз	Спондилолиз	\bспондилолиз[а-я]*		
Спонтанная эмфизема средостения	Спонтанная эмфизема средостения	\bспонтанн[а-я]+ эмфизем[а-я]+ средостени[а-я]+		
Спонтанный разрыв пищевода	Спонтанный разрыв пищевода	\bспонтанн[а-я]+ разрыв[а-я]* пищевода		
Споротрихоз	Споротрихоз	\bспоротрихоз[а-я]*		
Срединная дистрофия ногтей	Срединная дистрофия ногтей	\bсрединн[а-я]+ дистроф[а-я]+ ногтей		
Средний отит	Средний отит	\bсредний отит[а-я]*		
Стафилококковый менингит	Стафилококковый менингит	\bстафилококков[а-я]+ менингит[а-я]*		
Стеатогепатит	Стеатогепатит	\bстеатогепатит[а-я]*		
Стеатоз печени	Стеатоз печени	\bстеатоз[а-я]* печени		
Стеноз	Стеноз	\bстеноз[а-я]*(( аортальн| митральн| позвоночн)[а-я]+ клапан[а-я]*)?		
Стенокардия	Стенокардия	\bстенокарди[а-я]+		
Стенокардия Принцметала	Стенокардия Принцметала	\bстенокард[а-я]+ принцметала		
Стереотипия	Стереотипия	\bстереотипи[а-я]+		
Стимуляторный психоз	Стимуляторный психоз	\bстимуляторн[а-я]+ психоз[а-я]*		
Столбняк	Столбняк	\bстолбняк[а-я]*		
Стоматит	Стоматит	\bстоматит[а-я]*		
Стомоксоз	Стомоксоз	\bстомоксоз[а-я]*		
Стрептобациллёз	Стрептобациллёз	\bстрептобацилл(е|ё)з[а-я]*		
Стрептодермия	Стрептодермия	\bстрептодерми[а-я]+		
Стрессовый перелом	Стрессовый перелом	\bстрессов[а-я]+ перелом[а-я]*		
Стрии	Стрии	\bстри[а-я]+		
Стронгилоидоз	Стронгилоидоз	\bстронгилоидоз[а-я]*		
Субарахноидальное кровоизлияние	Субарахноидальное кровоизлияние	\bсубарахноидальн[а-я]* кровоизлияни[а-я]+		
Субдуральная гематома	Субдуральная гематома	\bсубдуральн[а-я]+ гематом[а-я]*		
Субэпителиальная муцинозная дистрофия роговицы	Субэпителиальная муцинозная дистрофия роговицы	\bсубэпителиальн[а-я]+ муцинозн[а-я]+ дистрофи[а-я]+ роговицы		
Сухой кератоконъюнктивит	Сухой кератоконъюнктивит	\bсух[а-я]* кератоконъюнктивит[а-я]*		
Сфинголипидоз	Сфинголипидоз	\bсфинголипидоз[а-я]*		
Сывороточная болезнь	Сывороточная болезнь	\bсывороточн[а-я]+ болезн[а-я]+		
Сыпной тиф	Сыпной тиф	\bсыпн[а-я]+ тиф[а-я]*		
Тазовое предлежание	Тазовое предлежание	\bтазово[а-я]+ предлежани[а-я]+		
Тайдзин кёфусё	Тайдзин кёфусё	\bтайдзин к(е|ё)фус(е|ё)		
Таламический синдром	Таламический синдром	\bталамическ[а-я]+ синдром[а-я]*		
Талассемия	Талассемия	\bталассеми[а-я]+		
Тампонада сердца	Тампонада сердца	\bтампонад[а-я]+ сердца		
Таупатия	Таупатия	\bтаупати[а-я]+		
Теизм	Теизм	\bтеизм[а-я]*		
Телеангиэктазия	Телеангиэктазия	\bтелеангиэктази[а-я]+		
Телесное повреждение	Телесное повреждение	\bтелесн[а-я]+ повреждени[а-я]+		
Телязиоз	Телязиоз	\bтелязиоз[а-я]*		
Тендинит	Тендинит	\bтендинит[а-я]*		
Тениаринхоз	Тениаринхоз	\bтениаринхоз[а-я]*		
Тениоз	Тениоз	\bтениоз[а-я]*		
Тепловой удар	Тепловой удар	\bтеплово[а-я]* удар[а-я]*		
Тератома	Тератома	\bтератом[а-я]*		
Тернидентоз	Тернидентоз	\bтернидентоз[а-я]*		
Тестикулярный микролитиаз	Тестикулярный микролитиаз	\bтестикулярн[а-я]+ микролитиаз[а-я]*		
Тетрада Фалло	Тетрада Фалло	\bтетрад[а-я]* фалло		
Тиннитус	Тиннитус	\bтиннитус[а-я]*		
Тиреоидит	Тиреоидит	\bтиреоидит[а-я]*		
Тиреоидит де Кервена	Тиреоидит де Кервена	\bтиреоидит[а-я]* де кервена		
Тиреотоксический криз	Тиреотоксический криз	\bтиреотоксическ[а-я]+ криз[а-я]*		
Тирзокнемоз	Тирзокнемоз	\bтирзокнемоз[а-я]*		
Токсаскароз	Токсаскароз	\bтоксаскароз[а-я]*		
Токсидермия	Токсидермия	\bтоксидерми[а-я]+		
Токсикомания	Токсикомания	\bтоксикомани[а-я]+		
Токсическая аденома щитовидной железы	Токсическая аденома щитовидной железы	\bтоксическ[а-я]+ аденом[а-я]* щитовидной железы		
Токсичность парацетамола	Токсичность парацетамола	\bтоксичност[а-я]+ парацетамола		
Токсокароз	Токсокароз	\bтоксокароз[а-я]*		
Токсоплазмоз	Токсоплазмоз	\bтоксоплазмоз[а-я]*		
Томинксоз	Томинксоз	\bтоминксоз[а-я]*		
Тофус	Тофус	\bтофус[а-я]*		
Трабекулоэктомия	Трабекулоэктомия	\bтрабекулоэктоми[а-я]+		
Травматическая асфиксия	Травматическая асфиксия	\bтравматическ[а-я]+ асфикси[а-я]+		
Транзиторная ишемическая атака	Транзиторная ишемическая атака	\bтранзиторн[а-я]+ ишемическ[а-я]+ атак[а-я]+		
Транспозиция магистральных сосудов	Транспозиция магистральных сосудов	\bтранспозиц[а-я]+ магистральных сосудов		
Транспозиция органов	Транспозиция органов	\bтранспозиц[а-я]+ органов		
Транссексуальность	Транссексуальность	\bтранссексуальност[а-я]+		
Траншейная стопа	Траншейная стопа	\bтраншейн[а-я]+ стоп[а-я]*		
Трахеит	Трахеит	\bтрахеит[а-я]*		
Трахома	Трахома	\bтрахом[а-я]*		
Тревожное расстройство	Тревожное расстройство	\bтревожно[а-я]+ расстройств[а-я]*( личности)?		
Тревожный невроз	Тревожный невроз	\bтревожн[а-я]+ невроз[а-я]*		
Трематодозы	Трематодозы	\bтрематодоз[а-я]*		
Трещина заднего прохода	Трещина заднего прохода	\bтрещин[а-я]* заднего прохода		
Триада Фалло	Триада Фалло	\bтриад[а-я]+ фалло		
Трипаносомозы	Трипаносомозы	\bтрипаносомоз[а-я]*		
Трихиаз	Трихиаз	\bтрихиаз[а-я]*		
Трихинеллёз	Трихинеллёз	\bтрихинелл(е|ё)з[а-я]*		
Трихомониаз	Трихомониаз	\bтрихомониаз[а-я]*		
Трихотилломания	Трихотилломания	\bтрихотилломани[а-я]+		
Трихотиодистрофия	Трихотиодистрофия	\bтрихотиодистрофи[а-я]+		
Трихофагия	Трихофагия	\bтрихофаги[а-я]+		
Трихофития	Трихофития	\bтрихофит[а-я]*		
Трихоцефалёз	Трихоцефалёз	\bтрихоцефал(е|ё)з[а-я]*		
Тройной синдром	Тройной синдром	\bтройн[а-я]* синдром[а-я]*		
Тромбидиаз	Тромбидиаз	\bтромбидиаз[а-я]*		
Тромбоз	Тромбоз	\bтромбоз[а-я]*( глубоких вен| кавернозного синуса| синус[а-я]+ тв(е|ё)рдой мозговой оболочки)?		
Тромбофилия	Тромбофилия	\bтромбофили[а-я]+		
Тромбофлебит	Тромбофлебит	\bтромбофлебит[а-я]*		
Тромбоцитопения	Тромбоцитопения	\bтромбоцитопени[а-я]+		
Тромбоэмболия лёгочной артерии	Тромбоэмболия лёгочной артерии	\bтромбоэмбол[а-я]+ л(е|ё)гочной артерии		
Тропическая легочная эозинофилия	Тропическая легочная эозинофилия	\bтропическ[а-я]+ л(е|ё)гочн[а-я]+ эозинофил[а-я]+		
Трофобластическая болезнь	Трофобластическая болезнь	\bтрофобластическ[а-я]+ болезн[а-я]*		
Туберкулёз	Туберкулёз	\bтуберкул(е|ё)з[а-я]*( л(е|ё)гких)?		
Туберозный склероз	Туберозный склероз	\bтуберозн[а-я]+ склероз[а-я]*		
Тубулопатии	Тубулопатии	\bтубулопати[а-я]*		
Туляремия	Туляремия	\bтуляреми[а-я]+		
Тяжёлый комбинированный иммунодефицит	Тяжёлый комбинированный иммунодефицит	\bтяж(е|ё)л[а-я]+ комбинированн[а-я]+ иммунодефицит[а-я]*		
Увеит	Увеит	\bувеит[а-я]*		
Удушье дымом	Удушье дымом	\bудушь[а-я]+ дымом		
Ужаления и укусы насекомых	Ужаления и укусы насекомых	\b(ужален|укус)[а-я]* насеком[а-я]*		
Узелковый периартериит	Узелковый периартериит	\bузелков[а-я]+ периартериит[а-я]*		
Узловой зоб	Узловой зоб	\bузлово[а-я]* зоб[а-я]*		
Укус	Укус	\bуку(c|ш)[а-я]*( паука| многоножек| насекомых| членистоногих| ран[а-я]*)		
Укушенная рана	Укушенная рана	\bукушенн[а-я]+ ран[а-я]*		
Умственная отсталость	Умственная отсталость	\bумственн[а-я]+ отсталост[а-я]+		
Уремия	Уремия	\bуреми[а-я]+		
Уретероцеле	Уретероцеле	\bуретероцеле		
Уретрит	Уретрит	\bуретрит[а-я]*		
Утопление	Утопление	\bутоплени[а-я]+		
Ушиб	Ушиб	\bушиб[а-я]*( головн[а-я]* мозг[а-я]*)?		
Ушиб головного мозга	Ушиб головного мозга	\bушиб[а-я]* головн[а-я]* мозг[а-я]*		
Ушибленно-рваная рана	Ушибленно-рваная рана	\bушибленно-рван[а-я]+ ран[а-я]*		
Факоматозы	Факоматозы	\bфакомтоз[а-я]*		
Фантомная конечность	Фантомная конечность	\bфантомн[а-я]+ конечност[а-я]+		
Фарингит	Фарингит	\bфарингит[а-я]*		
Фасциол(е|ё)з	Фасциол(е|ё)з	\bфасциол(ё|е)з[а-я]*		
Фасциолопсидоз	Фасциолопсидоз	\bфасциолопсидоз[а-я]*		
Фатальная семейная бессонница	Фатальная семейная бессонница	\bфатальн[а-я]+ семейн[а-я]+ бессонниц[а-я]+		
Фебрильная нейтропения	Фебрильная нейтропения	\bфебрильн[а-я]+ нейтропени[а-я]+		
Фебрильная шизофрения	Фебрильная шизофрения	\bфебрильн[а-я]+ шизофрени[а-я]+		
Фенилкетонурия	Фенилкетонурия	\bфенилкетонури[а-я]+		
Феохромоцитома	Феохромоцитома	\bфеохромоцитом[а-я]*		
Фетальный алкогольный синдром	Фетальный алкогольный синдром	\bфетальн[а-я]+ алкогольн[а-я]+ синдром[а-я]*		
Фето-фетальный трансфузионный синдром	Фето-фетальный трансфузионный синдром	\bфето-фетальн[а-я]+ трансфузионн[а-я]+ синдром[а-я]*		
Фибрилляция предсердий	Фибрилляция предсердий	\bфибрилляц[а-я]+ предсердий		
Фиброаденома	Фиброаденома	\bфиброаденом[а-я]*		
Фибродисплазия	Фибродисплазия	\bфибродисплази[а-я]+		
Фиброз	Фиброз	\bфиброз[а-я]*		
Фиброма	Фиброма	\bфибром[а-я]*		
Фибромиалгия	Фибромиалгия	\bфибромиалги[а-я]+		
Фибросаркома	Фибросаркома	\bфибросарком[а-я]*		
Физиологическая желтуха новорождённых	Физиологическая желтуха новорождённых	\bфизиологическ[а-я]+ желтух[а-я]+ новорожд(е|ё)нн[а-я]+		
Филяриатозы	Филяриатозы	\bфиляриатоз[а-я]*		
Фимоз	Фимоз	\bфимоз[а-я]*		
Фитофотодерматит	Фитофотодерматит	\bфитофотодерматит[а-я]*		
Флебит	Флебит	\bфлебит[а-я]*		
Флеботодермия	Флеботодермия	\bфлеботодерми[а-я]+		
Флотирующие переломы рёбер	Флотирующие переломы рёбер	\bфлотирующ[а-я]+ перелом[а-я]* р(е|ё)бер		
Флюороз (стоматология)	Флюороз (стоматология)	\bфлюороз[а-я]*		
Фобия	Фобия	\bфоби[а-я]+		
Фолликулит	Фолликулит	\bфолликулит[а-я]*		
Форидоз	Форидоз	\bфоридоз[а-я]*		
Фотодерматоз	Фотодерматоз	\bфотодерматоз[а-я]*		
Фрамбезия	Фрамбезия	\bфрамбези[а-я]+		
Френит	Френит	\bфренит[а-я]*		
Фтизис глазного яблока	Фтизис глазного яблока	\bфтизис[а-я]* глазн[а-я]+ яблок[а-я]*		
Фтириаз	Фтириаз	\bфтириаз[а-я]*		
Фукозидоз	Фукозидоз	\bфукозидоз[а-я]*		
Фурункул	Фурункул	\bфурункул[а-я]*		
Халязион	Халязион	\bхалязион[а-я]*		
Хантавирусный кардиопульмональный синдром	Хантавирусный кардиопульмональный синдром	\bхантавирусн[а-я]+ кардиопульмональн[а-я]+ синдром[а-я]*		
Хейлетоз	Хейлетоз	\bхейлетоз[а-я]*		
Хейлит	Хейлит	\bхейлит[а-я]*		
Хеликобактериоз	Хеликобактериоз	\bхеликобактериоз[а-я]*		
Херувизм	Херувизм	\bхерувизм[а-я]*		
Хилоторакс	Хилоторакс	\bхилоторакс[а-я]*		
Хламидиоз	Хламидиоз	\bхламидиоз[а-я]*		
Холангиокарцинома	Холангиокарцинома	\bхолангиокарцином[а-я]*		
Холангит	Холангит	\bхолангит[а-я]*		
Холера	Холера	\bхолер[а-я]*		
Холестеатома	Холестеатома	\bхолестеатом[а-я]*		
Холецистит	Холецистит	\bхолецистит[а-я]*		
Холодовая аллергия	Холодовая аллергия	\bхолодов[а-я]+ аллерги[а-я]+		
Хондробластома	Хондробластома	\bхондробластом[а-я]*		
Хондрома	Хондрома	\bхондром[а-я]*		
Хондросаркома	Хондросаркома	\bхондросарком[а-я]*		
Хордома	Хордома	\bхордом[а-я]*		
Хориоидпапиллома	Хориоидпапиллома	\bхориоидпапиллом[а-я]*		
Хороидермия	Хороидермия	\bхороидерми[а-я]+		
Хризомиаз	Хризомиаз	\bхризомиаз[а-я]*		
Хроническая болезнь почек	Хроническая болезнь почек	\bхроническ[а-я]+( болезн[а-я]* почек| обструктивн[а-я]* болезн[а-я]* л(е|ё)гких| лимфолейкоз[а-я]*| миелоидн[а-я]* лейкоз[а-я]*| панкреатит[а-я]*| тиреоидит[а-я]*| тонзиллит[а-я]*)		
Целиакия	Целиакия	\bцелиаки[а-я]*		
Целлюлит (воспаление)	Целлюлит (воспаление)	\bцеллюлит[а-я]*		
Цементома	Цементома	\bцементом[а-я]*		
Центральная окклюзия вен сетчатки	Центральная окклюзия вен сетчатки	\bцентральн[а-я]+ окклюз[а-я]+ вен сетчатки		
Центральная серозная ретинопатия	Центральная серозная ретинопатия	\bцентральн[а-я]+ серозн[а-я]+ ретинопати[а-я]+		
Ценуроз	Ценуроз	\bценуроз[а-я]*		
Цервицит	Цервицит	\bцервицит[а-я]*		
Церебрастения	Церебрастения	\bцеребрастени[а-я]+		
Цереброваскулярные болезни	Цереброваскулярные болезни	\bцереброваскулярн[а-я]+ болезн[а-я]+		
Церкариоз	Церкариоз	\bцеркариоз[а-я]*		
Циклопия	Циклопия	\bциклопи[а-я]+		
Циклотимия	Циклотимия	\bциклотими[а-я]+		
Циклотропия	Циклотропия	\bциклотропи[а-я]+		
Цинга	Цинга	\bцинг[а-я]*		
Цирроз печени	Цирроз печени	\bцирроз[а-я]*		
Цистиноз	Цистиноз	\bцистиноз[а-я]*		
Цистинурия	Цистинурия	\bцистинури[а-я]+		
Цистит	Цистит	\bцистит[а-я]*		
Цистицеркоз	Цистицеркоз	\bцистицеркоз[а-я]*		
Цитодитоз	Цитодитоз	\bцитодитоз[а-я]*		
Цитомегаловирусная инфекция	Цитомегаловирусная инфекция	\bцитомегаловирусн[а-я]+( инфекци[а-я]+| ретинит[а-я]*)		
Цуцугамуши	Цуцугамуши	\bцуцугамуши		
Черепно-мозговая травма	Черепно-мозговая травма	\bчерепно-мозгов[а-я]+ травм[а-я]*		
Чёрный акантоз	Чёрный акантоз	\bч(е|ё)рн[а-я]+ акантоз[а-я]*		
Чесотка	Чесотка	\bчесотк[а-я]+		
Чума	Чума	\bчум[а-я]+( крупного рогатого скота)?		
Шигеллёз	Шигеллёз	\bшигелл(е|ё)з[а-я]*		
Шизоаффективное расстройство	Шизоаффективное расстройство	\bшизоаффективн[а-я]+ расстройств[а-я]+		
Шизоидное расстройство личности	Шизоидное расстройство личности	\bшизоидн[а-я]+ расстройств[а-я]+ личности		
Шизотипическое расстройство	Шизотипическое расстройство	\bшизотипическ[а-я]+ расстройств[а-я]+		
Шизофреническая реакция	Шизофреническая реакция	\bшизофреническ[а-я]+ реакц[а-я]+		
Шизофрения	Шизофрения	\bшизофрени[а-я]+		
Шизофреноподобное расстройство	Шизофреноподобное расстройство	\bшизофреноподобн[а-я]+ расстройств[а-я]*		
Шизофреноформное расстройство	Шизофреноформное расстройство	\bшизофреноформн[а-я]+ расстройств[а-я]*		
Шистосомоз	Шистосомоз	\bшистосомоз[а-я]*		
Шок	Шок	\bшок[а-я]*		
Геморрагическая лихорадка Эбола	Геморрагическая лихорадка Эбола	\bгеморрагическ[а-я]+ лихорадк[а-я]+ эбола		
Эвритремоз	Эвритремоз	\bэвритремоз[а-я]*		
Эгодистоническая половая ориентация	Эгодистоническая половая ориентация	\bэгодистоническ[а-я]+ полов[а-я]+ ориентаци[а-я]+		
Эдемагеноз	Эдемагеноз	\bэдемагеноз[а-я]*		
Эзотропия	Эзотропия	\bэзотропи[а-я]*		
Эзофагит	Эзофагит	\bэзофагит[а-я]*		
Эзофагостомоз	Эзофагостомоз	\bэзофагостомоз[а-я]*		
Эзофория	Эзофория	\bэзофори[а-я]+		
Экзема	Экзема	\bэкзем[а-я]*		
Экзогенный аллергический альвеолит	Экзогенный аллергический альвеолит	\bэкзогенн[а-я]+ аллергическ[а-я]+ альвеолит[а-я]*		
Экзофория	Экзофория	\bэкзофори[а-я]+		
Экзофтальм	Экзофтальм	\bэкзофтальм[а-я]*		
Эклампсия	Эклампсия	\bэклампси[а-я]+		
Эксгибиционизм	Эксгибиционизм	\bэксгибиционизм[а-я]*		
Экстрасистолия	Экстрасистолия	\bэкстрасистоли[а-я]+		
Экстрофия мочевого пузыря	Экстрофия мочевого пузыря	\bэкстроф[а-я]+ мочевого пузыря		
Эктопия сердца	Эктопия сердца	\bэктоп[а-я]+ (сердца|шейки матки)		
Эктродактилия	Эктродактилия	\bэктродактили[а-я]+		
Эктропион шейки матки	Эктропион шейки матки	\bэктропион[а-я]* шейки матки		
Элефантиаз	Элефантиаз	\bэлефантиаз[а-я]*		
Эмболия	Эмболия	\bэмболи[а-я]+		
Эмоционально неустойчивое расстройство личности	Эмоционально неустойчивое расстройство личности	\bэмоционально неустойчивое расстройство личности		
Эмпиема плевры	Эмпиема плевры	\bэмпием[а-я]+( плевры)?		
Эмфизема лёгких	Эмфизема лёгких	\bэмфизем[а-я]+ л(е|ё)гк[а-я]+		
Эмфизематозный пиелонефрит	Эмфизематозный пиелонефрит	\bэмфизематозн[а-я]+ пиелонефрит[а-я]*		
Эндартериит	Эндартериит	\bэндартериит[а-я]*		
Эндемический зоб	Эндемический зоб	\bэндемическ[а-я]+ зоб[а-я]*		
Эндогенная депрессия	Эндогенная депрессия	\bэндогенн[а-я]+ депресси[а-я]+		
Эндокардит	Эндокардит	\bэндокардит[а-я]*		
Эндокринные заболевания	Эндокринные заболевания	\bэндокринн[а-я]+ заболевани[а-я]+		
Эндометриоз	Эндометриоз	\bэндометриоз[а-я]*		
Эндометрит	Эндометрит	\bэндометрит[а-я]*		
Эндотелиальная дистрофия роговицы	Эндотелиальная дистрофия роговицы	\bэндотелиальн[а-я]+ дистроф[а-я]+ роговиц[а-я]*		
Энкопрез	Энкопрез	\bэнкопрез[а-я]*		
Энофтальм	Энофтальм	\bэнофтальм[а-я]*		
Энтерит	Энтерит	\bэнтерит[а-я]*		
Энтеробиоз	Энтеробиоз	\bэнтеробиоз[а-я]*		
Энтеровирусный везикулярный стоматит	Энтеровирусный везикулярный стоматит	\bэнтеровирусн[а-я]+ везикулярн[а-я]+ стоматит[а-я]*		
Энтероколит	Энтероколит	\bэнтероколит[а-я]*		
Энтероптоз	Энтероптоз	\bэнтероптоз[а-я]*		
Энтропион	Энтропион	\bэнтропион[а-я]*		
Энурез	Энурез	\bэнурез[а-я]*		
Энцефалит	Энцефалит	\bэнцефалит[а-я]*( расмуссена| сент-луис)?		
Энцефалопатия	Энцефалопатия	\bэнцефалопати[а-я]+( бокс(е|ё)ров)?		
Энцефалотригеминальный ангиоматоз	Энцефалотригеминальный ангиоматоз	\bэнцефалотригеминальн[а-я]+ ангиоматоз[а-я]*		
Эозинофилия	Эозинофилия	\bэозинофили[а-я]+		
Эозинофильная пневмония	Эозинофильная пневмония	\bэозинофильн[а-я]+ пневмони[а-я]+		
Эпендимома	Эпендимома	\bэпендимом[а-я]+		
Эпидемический паротит	Эпидемический паротит	\bэпидемическ[а-я]+ паротит[а-я]*		
Эпидемический сыпной тиф	Эпидемический сыпной тиф	\bэпидемическ[а-я]+ сыпн[а-я]+ тиф[а-я]*		
Эпидидимит	Эпидидимит	\bэпидидимит[а-я]*		
Эпилепсия	Эпилепсия	\bэпилепси[а-я]+		
Эпилептический статус	Эпилептический статус	\bэпилептическ[а-я]+		
Эписпадия	Эписпадия	\bэписпади[а-я]+		
Эпифизеолиз	Эпифизеолиз	\bэпифизеолиз[а-я]*		
Эпифора (медицина)	Эпифора (медицина)	\bэпифор[а-я]+		
Эрготизм	Эрготизм	\bэрготизм[а-я]*		
Эректильная дисфункция	Эректильная дисфункция	\bэректильн[а-я]+ дисфункци[а-я]+		
Эризипелоид	Эризипелоид	\bэризипелоид[а-я]*		
Эритема мигрирующая хроническая	Эритема мигрирующая хроническая	\bэритем[а-я]+( мигрирующ[а-я]+( хроническ[а-я]+)?)?		
Эритроплакия	Эритроплакия	\bэритроплаки[а-я]+		
Эрозия шейки матки	Эрозия шейки матки	\bэрози[а-я]* шейки матки		
Эссенциальная гипертензия	Эссенциальная гипертензия	\bэссенциальн[а-я]+ (гипертензи|фруктозури)[а-я]+		
Эстроз	Эстроз	\bэстроз[а-я]*		
Эхинококкоз	Эхинококкоз	\bэхинококкоз[а-я]*		
Эшерихиоз	Эшерихиоз	\bэшерихиоз[а-я]*		
Юксовская болезнь	Юксовская болезнь	\bюксовск[а-я]+ болезн[а-я]+		
Ядерная желтуха	Ядерная желтуха	\bядерн[а-я]+ желтух[а-я]*		
Язва Бурули	Язва Бурули	\bязв[а-я]*( бурули| двенадцатиперстной кишки| кишечника| желудка| роговицы)?		
Язвенный колит	Язвенный колит	\bязвенн[а-я]+ колит[а-я]*		
Японский энцефалит	Японский энцефалит	\bяпонск[а-я]+ энцефалит[а-я]*		
Ячмень	Ячмень	\bячмен[а-я]+		
Ящур	Ящур	\bящур[а-я]*		